ID,Флаг дозвона,Флаг продажи,Расходы,PV,NPV
0,0,0,89,0,-89
1,1,0,114,0,-114
2,1,1,147,1246,1099
3,1,0,3,0,-3
4,1,0,18,0,-18
5,0,0,27,0,-27
6,1,1,229,1737,1508
7,1,1,336,1286,950
8,1,0,0,0,0
9,1,0,52,0,-52
10,0,0,80,0,-80
11,0,0,47,0,-47
12,0,0,24,0,-24
13,0,0,144,0,-144
14,0,0,62,0,-62
15,1,1,1233,3243,2010
16,1,1,1,2364,2363
17,1,1,658,1393,735
18,0,0,41,0,-41
19,1,0,103,0,-103
20,1,1,616,1626,1010
21,1,0,13,0,-13
22,1,1,2581,1749,-832
23,1,0,3,0,-3
24,0,0,150,0,-150
25,0,0,22,0,-22
26,1,0,167,0,-167
27,1,0,62,0,-62
28,1,1,183,1299,1116
29,0,0,41,0,-41
30,1,1,311,1280,969
31,1,1,1748,2705,957
32,0,0,18,0,-18
33,0,0,61,0,-61
34,1,1,44,1481,1437
35,1,1,344,2496,2152
36,1,1,2012,1202,-810
37,1,0,42,0,-42
38,1,0,131,0,-131
39,1,0,81,0,-81
40,1,0,27,0,-27
41,0,0,90,0,-90
42,0,0,14,0,-14
43,1,0,2,0,-2
44,1,0,6,0,-6
45,0,0,5,0,-5
46,0,0,5,0,-5
47,1,1,828,1325,497
48,1,1,187,1933,1746
49,1,0,13,0,-13
50,1,0,20,0,-20
51,0,0,51,0,-51
52,0,0,10,0,-10
53,1,1,333,1710,1377
54,1,1,708,1313,605
55,1,0,72,0,-72
56,0,0,35,0,-35
57,0,0,9,0,-9
58,1,0,103,0,-103
59,0,0,45,0,-45
60,0,0,8,0,-8
61,1,0,94,0,-94
62,0,0,18,0,-18
63,1,0,36,0,-36
64,0,0,45,0,-45
65,1,0,53,0,-53
66,1,0,0,0,0
67,1,1,238,1243,1005
68,1,1,659,1726,1067
69,1,0,0,0,0
70,0,0,48,0,-48
71,1,1,213,1567,1354
72,1,0,21,0,-21
73,0,0,21,0,-21
74,0,0,69,0,-69
75,0,0,51,0,-51
76,0,0,32,0,-32
77,1,1,182,1859,1677
78,1,0,49,0,-49
79,1,1,1029,1435,406
80,0,0,55,0,-55
81,0,0,46,0,-46
82,0,0,7,0,-7
83,1,0,75,0,-75
84,1,1,39,1487,1448
85,1,1,28,1455,1427
86,0,0,58,0,-58
87,1,1,567,1479,912
88,0,0,48,0,-48
89,1,1,292,1433,1141
90,1,0,77,0,-77
91,0,0,27,0,-27
92,1,0,51,0,-51
93,0,0,17,0,-17
94,0,0,61,0,-61
95,1,0,28,0,-28
96,1,1,1339,1440,101
97,0,0,0,0,0
98,0,0,52,0,-52
99,1,1,198,1296,1098
100,1,0,41,0,-41
101,1,1,342,1361,1019
102,1,0,66,0,-66
103,0,0,17,0,-17
104,0,0,25,0,-25
105,1,0,6,0,-6
106,0,0,120,0,-120
107,1,0,42,0,-42
108,1,1,99,1286,1187
109,1,0,18,0,-18
110,1,0,80,0,-80
111,1,1,1285,2536,1251
112,1,1,546,1457,911
113,0,0,15,0,-15
114,0,0,26,0,-26
115,0,0,61,0,-61
116,1,0,40,0,-40
117,1,0,31,0,-31
118,0,0,49,0,-49
119,0,0,72,0,-72
120,1,0,109,0,-109
121,0,0,87,0,-87
122,1,0,28,0,-28
123,0,0,37,0,-37
124,1,0,2,0,-2
125,1,1,430,1770,1340
126,1,1,704,1516,812
127,0,0,97,0,-97
128,1,0,52,0,-52
129,0,0,91,0,-91
130,1,0,55,0,-55
131,0,0,39,0,-39
132,1,1,307,1910,1603
133,1,1,119,1871,1752
134,1,1,830,1311,481
135,0,0,213,0,-213
136,1,1,106,1424,1318
137,0,0,36,0,-36
138,1,1,607,1383,776
139,0,0,1,0,-1
140,1,0,10,0,-10
141,0,0,113,0,-113
142,1,1,519,1439,920
143,0,0,7,0,-7
144,0,0,10,0,-10
145,1,0,30,0,-30
146,1,0,110,0,-110
147,1,1,655,1331,676
148,1,0,35,0,-35
149,1,0,9,0,-9
150,0,0,136,0,-136
151,0,0,12,0,-12
152,1,0,4,0,-4
153,0,0,6,0,-6
154,1,1,840,1302,462
155,1,1,257,1843,1586
156,0,0,86,0,-86
157,0,0,6,0,-6
158,0,0,7,0,-7
159,1,0,56,0,-56
160,0,0,168,0,-168
161,1,0,35,0,-35
162,0,0,14,0,-14
163,1,0,146,0,-146
164,1,0,24,0,-24
165,1,0,69,0,-69
166,0,0,23,0,-23
167,0,0,73,0,-73
168,1,1,424,1963,1539
169,1,0,12,0,-12
170,1,0,51,0,-51
171,1,1,73,1307,1234
172,1,1,785,1457,672
173,1,1,226,1255,1029
174,1,0,29,0,-29
175,1,0,53,0,-53
176,0,0,63,0,-63
177,1,0,46,0,-46
178,0,0,8,0,-8
179,1,0,68,0,-68
180,1,0,60,0,-60
181,1,1,446,2109,1663
182,1,1,11,1215,1204
183,1,1,1922,1603,-319
184,1,1,282,1259,977
185,1,0,46,0,-46
186,0,0,4,0,-4
187,1,1,369,1779,1410
188,0,0,10,0,-10
189,1,0,7,0,-7
190,0,0,2,0,-2
191,0,0,186,0,-186
192,0,0,69,0,-69
193,1,0,128,0,-128
194,0,0,98,0,-98
195,0,0,23,0,-23
196,0,0,111,0,-111
197,1,1,1633,1257,-376
198,0,0,32,0,-32
199,1,0,22,0,-22
200,1,1,564,2117,1553
201,1,1,279,1702,1423
202,1,0,64,0,-64
203,1,0,165,0,-165
204,1,0,16,0,-16
205,1,1,111,1580,1469
206,1,0,89,0,-89
207,1,1,697,1219,522
208,1,1,254,1900,1646
209,0,0,46,0,-46
210,0,0,36,0,-36
211,1,0,4,0,-4
212,1,1,604,1717,1113
213,0,0,26,0,-26
214,0,0,20,0,-20
215,1,0,36,0,-36
216,0,0,63,0,-63
217,1,0,17,0,-17
218,1,1,524,1255,731
219,1,0,21,0,-21
220,0,0,32,0,-32
221,1,0,49,0,-49
222,0,0,1,0,-1
223,0,0,59,0,-59
224,0,0,336,0,-336
225,0,0,56,0,-56
226,0,0,13,0,-13
227,0,0,9,0,-9
228,0,0,66,0,-66
229,1,0,6,0,-6
230,0,0,56,0,-56
231,1,1,308,1312,1004
232,0,0,18,0,-18
233,0,0,18,0,-18
234,1,1,212,1377,1165
235,1,0,7,0,-7
236,1,1,215,1381,1166
237,0,0,7,0,-7
238,1,1,352,1521,1169
239,0,0,9,0,-9
240,0,0,64,0,-64
241,0,0,29,0,-29
242,0,0,47,0,-47
243,1,0,56,0,-56
244,1,1,433,1321,888
245,0,0,1,0,-1
246,1,1,30,1763,1733
247,0,0,6,0,-6
248,1,0,5,0,-5
249,0,0,11,0,-11
250,1,1,611,1436,825
251,0,0,1,0,-1
252,1,0,32,0,-32
253,0,0,126,0,-126
254,1,0,81,0,-81
255,1,0,42,0,-42
256,1,1,117,1210,1093
257,0,0,7,0,-7
258,1,0,66,0,-66
259,0,0,2,0,-2
260,1,0,88,0,-88
261,1,1,1711,1314,-397
262,1,1,1226,1368,142
263,0,0,13,0,-13
264,0,0,41,0,-41
265,1,0,18,0,-18
266,1,0,36,0,-36
267,0,0,14,0,-14
268,0,0,23,0,-23
269,1,0,24,0,-24
270,1,0,65,0,-65
271,1,1,511,1778,1267
272,0,0,9,0,-9
273,1,0,22,0,-22
274,1,1,1227,2268,1041
275,1,1,171,2152,1981
276,1,1,36,1210,1174
277,0,0,81,0,-81
278,1,0,56,0,-56
279,0,0,44,0,-44
280,0,0,16,0,-16
281,1,0,38,0,-38
282,0,0,10,0,-10
283,1,0,4,0,-4
284,1,0,0,0,0
285,1,0,59,0,-59
286,0,0,9,0,-9
287,1,0,61,0,-61
288,1,1,136,1262,1126
289,0,0,69,0,-69
290,0,0,1,0,-1
291,0,0,127,0,-127
292,1,1,113,1469,1356
293,0,0,10,0,-10
294,0,0,33,0,-33
295,1,1,363,2075,1712
296,1,1,257,2749,2492
297,0,0,4,0,-4
298,1,0,15,0,-15
299,0,0,2,0,-2
300,0,0,41,0,-41
301,1,1,398,1362,964
302,1,1,426,2385,1959
303,1,1,645,1217,572
304,1,0,97,0,-97
305,0,0,16,0,-16
306,0,0,33,0,-33
307,1,1,60,2910,2850
308,1,0,28,0,-28
309,1,1,151,1623,1472
310,1,1,1016,1581,565
311,0,0,96,0,-96
312,1,1,253,1444,1191
313,1,1,32,1464,1432
314,1,1,386,1512,1126
315,0,0,18,0,-18
316,1,0,59,0,-59
317,1,1,862,3237,2375
318,1,1,1415,1219,-196
319,0,0,60,0,-60
320,1,0,2,0,-2
321,1,0,20,0,-20
322,1,1,265,1284,1019
323,1,1,543,1385,842
324,1,0,26,0,-26
325,1,1,1494,1504,10
326,0,0,4,0,-4
327,1,0,195,0,-195
328,0,0,29,0,-29
329,1,1,247,1239,992
330,1,1,89,1244,1155
331,1,1,854,1678,824
332,0,0,55,0,-55
333,1,1,854,1757,903
334,0,0,48,0,-48
335,1,0,54,0,-54
336,1,1,167,1664,1497
337,1,1,606,1560,954
338,1,1,470,1326,856
339,0,0,40,0,-40
340,1,1,103,1417,1314
341,0,0,49,0,-49
342,0,0,163,0,-163
343,1,0,40,0,-40
344,0,0,57,0,-57
345,1,0,15,0,-15
346,1,0,8,0,-8
347,1,1,999,1305,306
348,1,0,64,0,-64
349,0,0,11,0,-11
350,1,1,1319,2445,1126
351,0,0,9,0,-9
352,0,0,17,0,-17
353,0,0,63,0,-63
354,1,0,8,0,-8
355,0,0,12,0,-12
356,1,1,223,1415,1192
357,1,1,592,1445,853
358,1,0,131,0,-131
359,1,1,138,2170,2032
360,1,0,33,0,-33
361,1,1,634,2338,1704
362,1,0,26,0,-26
363,1,0,16,0,-16
364,0,0,31,0,-31
365,0,0,11,0,-11
366,1,1,390,1404,1014
367,1,0,15,0,-15
368,1,1,288,2552,2264
369,1,0,56,0,-56
370,1,1,959,1303,344
371,0,0,18,0,-18
372,0,0,101,0,-101
373,1,1,1315,1822,507
374,0,0,19,0,-19
375,1,0,62,0,-62
376,0,0,169,0,-169
377,0,0,167,0,-167
378,0,0,14,0,-14
379,1,1,354,2153,1799
380,1,1,777,1476,699
381,0,0,8,0,-8
382,0,0,4,0,-4
383,1,0,54,0,-54
384,1,1,1443,1294,-149
385,1,0,2,0,-2
386,0,0,33,0,-33
387,1,1,1215,1283,68
388,1,1,934,1825,891
389,0,0,128,0,-128
390,0,0,19,0,-19
391,1,1,1250,1320,70
392,0,0,3,0,-3
393,1,1,834,1238,404
394,1,0,77,0,-77
395,1,0,54,0,-54
396,1,0,28,0,-28
397,1,0,27,0,-27
398,1,0,2,0,-2
399,0,0,44,0,-44
400,1,0,54,0,-54
401,1,1,484,2466,1982
402,1,0,131,0,-131
403,0,0,43,0,-43
404,0,0,15,0,-15
405,1,1,800,1429,629
406,0,0,18,0,-18
407,0,0,42,0,-42
408,0,0,126,0,-126
409,1,1,94,1270,1176
410,1,0,33,0,-33
411,0,0,1,0,-1
412,1,0,114,0,-114
413,1,0,82,0,-82
414,1,0,21,0,-21
415,0,0,40,0,-40
416,1,0,110,0,-110
417,1,0,3,0,-3
418,1,1,453,1468,1015
419,0,0,105,0,-105
420,1,0,10,0,-10
421,1,1,48,1679,1631
422,1,1,67,1405,1338
423,0,0,25,0,-25
424,0,0,107,0,-107
425,0,0,40,0,-40
426,0,0,58,0,-58
427,0,0,16,0,-16
428,1,0,12,0,-12
429,1,0,0,0,0
430,1,1,1006,1488,482
431,1,0,6,0,-6
432,1,1,1702,1245,-457
433,1,0,57,0,-57
434,1,0,17,0,-17
435,1,0,12,0,-12
436,0,0,41,0,-41
437,1,0,12,0,-12
438,1,0,64,0,-64
439,0,0,4,0,-4
440,1,0,23,0,-23
441,1,1,415,2435,2020
442,1,1,128,1295,1167
443,1,0,117,0,-117
444,1,0,3,0,-3
445,0,0,24,0,-24
446,0,0,7,0,-7
447,1,0,54,0,-54
448,0,0,4,0,-4
449,1,0,114,0,-114
450,0,0,16,0,-16
451,0,0,83,0,-83
452,0,0,42,0,-42
453,0,0,19,0,-19
454,1,1,91,1492,1401
455,1,1,438,1248,810
456,0,0,9,0,-9
457,1,1,297,1636,1339
458,0,0,64,0,-64
459,1,1,101,2082,1981
460,0,0,140,0,-140
461,0,0,61,0,-61
462,0,0,36,0,-36
463,1,0,6,0,-6
464,0,0,59,0,-59
465,1,1,153,1478,1325
466,1,0,5,0,-5
467,1,0,50,0,-50
468,1,0,133,0,-133
469,1,0,31,0,-31
470,0,0,30,0,-30
471,1,0,1,0,-1
472,1,0,13,0,-13
473,1,1,291,1573,1282
474,1,1,814,1438,624
475,1,1,553,1814,1261
476,1,1,118,3734,3616
477,1,0,12,0,-12
478,1,0,27,0,-27
479,0,0,51,0,-51
480,0,0,30,0,-30
481,0,0,12,0,-12
482,1,0,13,0,-13
483,0,0,16,0,-16
484,0,0,11,0,-11
485,1,0,5,0,-5
486,1,1,1118,1294,176
487,1,1,885,1437,552
488,1,1,594,3058,2464
489,0,0,53,0,-53
490,1,1,822,1437,615
491,1,1,312,1995,1683
492,1,1,1353,1890,537
493,1,0,1,0,-1
494,0,0,3,0,-3
495,1,1,29,1325,1296
496,1,0,3,0,-3
497,0,0,37,0,-37
498,0,0,6,0,-6
499,1,1,203,1497,1294
500,1,0,18,0,-18
501,1,0,118,0,-118
502,0,0,3,0,-3
503,1,0,14,0,-14
504,1,0,3,0,-3
505,1,1,130,2414,2284
506,1,0,62,0,-62
507,0,0,18,0,-18
508,1,1,356,1253,897
509,1,0,44,0,-44
510,0,0,166,0,-166
511,1,0,67,0,-67
512,1,0,9,0,-9
513,0,0,26,0,-26
514,1,0,120,0,-120
515,1,0,84,0,-84
516,1,1,816,1515,699
517,0,0,38,0,-38
518,0,0,9,0,-9
519,0,0,18,0,-18
520,1,0,128,0,-128
521,0,0,8,0,-8
522,0,0,8,0,-8
523,0,0,70,0,-70
524,1,0,105,0,-105
525,1,0,17,0,-17
526,1,0,151,0,-151
527,1,1,938,2080,1142
528,1,1,1578,2387,809
529,0,0,128,0,-128
530,0,0,27,0,-27
531,1,1,1223,1886,663
532,1,1,39,1300,1261
533,0,0,16,0,-16
534,1,0,21,0,-21
535,0,0,126,0,-126
536,1,1,405,1867,1462
537,1,1,274,2000,1726
538,0,0,59,0,-59
539,0,0,52,0,-52
540,1,0,63,0,-63
541,1,1,521,1426,905
542,0,0,48,0,-48
543,0,0,37,0,-37
544,0,0,36,0,-36
545,1,0,13,0,-13
546,0,0,77,0,-77
547,0,0,76,0,-76
548,1,0,39,0,-39
549,0,0,66,0,-66
550,1,0,127,0,-127
551,1,0,38,0,-38
552,0,0,55,0,-55
553,0,0,79,0,-79
554,1,1,2055,2318,263
555,1,0,52,0,-52
556,0,0,22,0,-22
557,0,0,42,0,-42
558,1,0,99,0,-99
559,1,0,66,0,-66
560,0,0,194,0,-194
561,1,1,1049,1581,532
562,1,1,444,1352,908
563,1,0,1,0,-1
564,0,0,94,0,-94
565,0,0,11,0,-11
566,0,0,15,0,-15
567,1,1,838,1335,497
568,0,0,67,0,-67
569,1,1,298,1861,1563
570,0,0,48,0,-48
571,0,0,109,0,-109
572,0,0,33,0,-33
573,1,0,79,0,-79
574,0,0,39,0,-39
575,1,1,1094,1230,136
576,0,0,15,0,-15
577,0,0,35,0,-35
578,0,0,9,0,-9
579,1,1,100,2177,2077
580,1,1,741,1410,669
581,0,0,172,0,-172
582,0,0,283,0,-283
583,1,0,70,0,-70
584,1,1,1308,1529,221
585,0,0,180,0,-180
586,1,0,26,0,-26
587,1,0,20,0,-20
588,0,0,0,0,0
589,1,0,22,0,-22
590,1,1,577,2009,1432
591,1,1,314,1291,977
592,1,0,11,0,-11
593,1,0,30,0,-30
594,1,1,325,1725,1400
595,0,0,9,0,-9
596,1,0,14,0,-14
597,0,0,47,0,-47
598,1,1,398,3947,3549
599,0,0,0,0,0
600,0,0,47,0,-47
601,0,0,33,0,-33
602,0,0,7,0,-7
603,0,0,62,0,-62
604,1,0,4,0,-4
605,1,1,660,1217,557
606,1,0,7,0,-7
607,1,1,1139,1430,291
608,1,0,55,0,-55
609,0,0,100,0,-100
610,1,1,206,1258,1052
611,1,0,13,0,-13
612,1,0,59,0,-59
613,1,1,287,1418,1131
614,0,0,313,0,-313
615,0,0,136,0,-136
616,1,0,17,0,-17
617,0,0,102,0,-102
618,1,0,73,0,-73
619,1,1,147,1560,1413
620,0,0,16,0,-16
621,1,0,156,0,-156
622,1,1,749,1813,1064
623,1,1,35,1580,1545
624,1,0,28,0,-28
625,1,0,62,0,-62
626,0,0,18,0,-18
627,1,0,16,0,-16
628,1,0,72,0,-72
629,1,0,79,0,-79
630,0,0,5,0,-5
631,1,1,70,1643,1573
632,0,0,4,0,-4
633,1,0,17,0,-17
634,1,1,167,1855,1688
635,1,1,465,1265,800
636,1,1,658,2636,1978
637,1,0,18,0,-18
638,0,0,16,0,-16
639,1,0,41,0,-41
640,0,0,49,0,-49
641,0,0,1,0,-1
642,0,0,5,0,-5
643,0,0,46,0,-46
644,0,0,51,0,-51
645,0,0,29,0,-29
646,1,0,131,0,-131
647,1,1,1212,1453,241
648,1,1,253,1291,1038
649,1,1,38,1456,1418
650,1,0,48,0,-48
651,0,0,20,0,-20
652,1,0,230,0,-230
653,0,0,43,0,-43
654,1,0,4,0,-4
655,0,0,4,0,-4
656,0,0,43,0,-43
657,0,0,29,0,-29
658,0,0,42,0,-42
659,0,0,212,0,-212
660,1,1,215,1347,1132
661,1,1,756,1221,465
662,1,1,907,1338,431
663,1,1,614,1686,1072
664,1,1,153,1499,1346
665,0,0,57,0,-57
666,0,0,7,0,-7
667,0,0,145,0,-145
668,1,1,517,1253,736
669,1,0,87,0,-87
670,0,0,97,0,-97
671,1,1,1075,2938,1863
672,1,1,405,1640,1235
673,1,0,207,0,-207
674,0,0,37,0,-37
675,1,1,199,1425,1226
676,1,0,58,0,-58
677,0,0,1,0,-1
678,1,1,1350,1567,217
679,1,0,18,0,-18
680,1,1,852,1394,542
681,1,0,31,0,-31
682,1,0,23,0,-23
683,0,0,145,0,-145
684,1,0,12,0,-12
685,1,0,46,0,-46
686,1,1,290,2197,1907
687,0,0,39,0,-39
688,0,0,4,0,-4
689,1,1,168,2249,2081
690,0,0,21,0,-21
691,1,1,220,1537,1317
692,1,1,1813,1240,-573
693,1,0,1,0,-1
694,1,0,52,0,-52
695,1,1,213,1516,1303
696,1,0,25,0,-25
697,1,0,4,0,-4
698,0,0,19,0,-19
699,1,1,262,1288,1026
700,0,0,17,0,-17
701,0,0,104,0,-104
702,1,1,154,1696,1542
703,0,0,118,0,-118
704,0,0,73,0,-73
705,0,0,82,0,-82
706,0,0,60,0,-60
707,1,1,401,1424,1023
708,0,0,19,0,-19
709,1,1,249,1447,1198
710,1,1,1053,1607,554
711,0,0,28,0,-28
712,0,0,17,0,-17
713,0,0,14,0,-14
714,1,0,37,0,-37
715,1,0,122,0,-122
716,1,0,0,0,0
717,1,0,152,0,-152
718,0,0,70,0,-70
719,1,0,2,0,-2
720,0,0,22,0,-22
721,0,0,114,0,-114
722,0,0,20,0,-20
723,1,0,10,0,-10
724,1,1,964,1414,450
725,1,0,16,0,-16
726,1,1,2078,1730,-348
727,1,1,1213,1215,2
728,1,1,641,1214,573
729,1,1,883,1998,1115
730,0,0,46,0,-46
731,1,1,146,1447,1301
732,1,0,56,0,-56
733,1,1,1454,1817,363
734,1,1,480,1834,1354
735,1,0,89,0,-89
736,1,1,136,1462,1326
737,1,0,23,0,-23
738,0,0,8,0,-8
739,0,0,2,0,-2
740,0,0,83,0,-83
741,1,1,2157,2946,789
742,1,1,83,1555,1472
743,1,0,0,0,0
744,1,0,172,0,-172
745,0,0,38,0,-38
746,1,1,173,1266,1093
747,1,0,109,0,-109
748,1,1,513,1385,872
749,0,0,21,0,-21
750,1,0,10,0,-10
751,1,0,45,0,-45
752,0,0,31,0,-31
753,0,0,75,0,-75
754,1,1,217,1494,1277
755,1,0,39,0,-39
756,1,0,36,0,-36
757,1,0,4,0,-4
758,1,1,646,2806,2160
759,1,1,112,1213,1101
760,0,0,83,0,-83
761,1,0,25,0,-25
762,1,0,4,0,-4
763,0,0,51,0,-51
764,0,0,59,0,-59
765,1,0,32,0,-32
766,0,0,89,0,-89
767,1,1,371,1360,989
768,0,0,17,0,-17
769,0,0,30,0,-30
770,1,0,5,0,-5
771,1,1,282,1699,1417
772,0,0,13,0,-13
773,1,0,71,0,-71
774,0,0,28,0,-28
775,0,0,142,0,-142
776,0,0,27,0,-27
777,1,1,205,2088,1883
778,0,0,7,0,-7
779,1,0,96,0,-96
780,1,0,53,0,-53
781,1,0,33,0,-33
782,0,0,56,0,-56
783,1,0,204,0,-204
784,0,0,29,0,-29
785,1,1,1763,1312,-451
786,0,0,53,0,-53
787,0,0,67,0,-67
788,0,0,9,0,-9
789,1,0,204,0,-204
790,0,0,116,0,-116
791,0,0,5,0,-5
792,1,0,65,0,-65
793,0,0,39,0,-39
794,1,0,33,0,-33
795,0,0,9,0,-9
796,0,0,17,0,-17
797,0,0,114,0,-114
798,0,0,119,0,-119
799,1,0,127,0,-127
800,0,0,17,0,-17
801,1,0,8,0,-8
802,1,1,732,1473,741
803,0,0,10,0,-10
804,0,0,7,0,-7
805,1,0,5,0,-5
806,1,0,3,0,-3
807,0,0,72,0,-72
808,1,1,181,1321,1140
809,1,1,428,1282,854
810,1,0,60,0,-60
811,1,0,104,0,-104
812,1,1,343,1200,857
813,1,0,87,0,-87
814,1,0,24,0,-24
815,1,1,184,1261,1077
816,1,0,11,0,-11
817,1,0,38,0,-38
818,1,1,1111,1522,411
819,1,1,1106,1409,303
820,1,0,16,0,-16
821,1,0,32,0,-32
822,1,1,1121,1415,294
823,1,1,501,1237,736
824,0,0,6,0,-6
825,1,0,82,0,-82
826,1,0,97,0,-97
827,1,0,4,0,-4
828,0,0,51,0,-51
829,1,0,5,0,-5
830,1,1,24,1260,1236
831,0,0,66,0,-66
832,0,0,9,0,-9
833,0,0,10,0,-10
834,1,0,24,0,-24
835,1,1,267,1475,1208
836,0,0,42,0,-42
837,1,0,30,0,-30
838,1,0,8,0,-8
839,0,0,6,0,-6
840,0,0,19,0,-19
841,1,0,36,0,-36
842,0,0,2,0,-2
843,1,0,25,0,-25
844,0,0,34,0,-34
845,1,1,361,3302,2941
846,1,0,29,0,-29
847,0,0,37,0,-37
848,0,0,110,0,-110
849,1,1,322,1857,1535
850,1,1,421,1419,998
851,1,1,5284,1267,-4017
852,1,1,639,1986,1347
853,1,0,85,0,-85
854,1,1,239,1536,1297
855,1,1,121,1246,1125
856,1,0,104,0,-104
857,1,1,678,1208,530
858,1,0,9,0,-9
859,0,0,79,0,-79
860,1,1,244,1772,1528
861,1,0,26,0,-26
862,0,0,96,0,-96
863,1,1,175,1319,1144
864,1,1,463,1356,893
865,0,0,87,0,-87
866,0,0,20,0,-20
867,1,0,64,0,-64
868,0,0,32,0,-32
869,1,0,120,0,-120
870,0,0,43,0,-43
871,1,0,25,0,-25
872,1,0,7,0,-7
873,1,0,18,0,-18
874,1,0,16,0,-16
875,1,1,307,1214,907
876,1,0,24,0,-24
877,1,1,48,1422,1374
878,0,0,115,0,-115
879,1,0,91,0,-91
880,1,1,95,1211,1116
881,0,0,235,0,-235
882,0,0,44,0,-44
883,0,0,92,0,-92
884,1,0,25,0,-25
885,0,0,12,0,-12
886,1,1,3769,1291,-2478
887,1,0,25,0,-25
888,0,0,7,0,-7
889,0,0,7,0,-7
890,0,0,35,0,-35
891,1,0,2,0,-2
892,1,0,21,0,-21
893,0,0,15,0,-15
894,1,1,38,1205,1167
895,0,0,68,0,-68
896,1,1,890,1927,1037
897,0,0,5,0,-5
898,0,0,5,0,-5
899,1,0,86,0,-86
900,1,1,304,1277,973
901,0,0,5,0,-5
902,1,0,42,0,-42
903,0,0,42,0,-42
904,1,1,1476,1395,-81
905,1,0,176,0,-176
906,1,1,18,1295,1277
907,0,0,14,0,-14
908,1,1,926,1302,376
909,0,0,13,0,-13
910,1,0,180,0,-180
911,1,0,9,0,-9
912,1,0,2,0,-2
913,1,1,1189,1417,228
914,1,1,265,1312,1047
915,1,1,398,1812,1414
916,0,0,2,0,-2
917,1,0,91,0,-91
918,0,0,3,0,-3
919,1,1,153,1408,1255
920,0,0,94,0,-94
921,1,1,825,1643,818
922,1,0,35,0,-35
923,0,0,21,0,-21
924,0,0,68,0,-68
925,0,0,0,0,0
926,1,0,15,0,-15
927,0,0,24,0,-24
928,1,0,78,0,-78
929,0,0,1,0,-1
930,0,0,57,0,-57
931,0,0,1,0,-1
932,0,0,20,0,-20
933,0,0,19,0,-19
934,1,1,269,1247,978
935,1,1,676,1340,664
936,1,0,18,0,-18
937,1,1,174,1394,1220
938,0,0,27,0,-27
939,1,0,62,0,-62
940,1,1,384,1641,1257
941,1,0,13,0,-13
942,1,0,12,0,-12
943,0,0,61,0,-61
944,1,0,11,0,-11
945,1,1,130,1679,1549
946,1,0,182,0,-182
947,0,0,34,0,-34
948,0,0,1,0,-1
949,1,0,89,0,-89
950,1,0,26,0,-26
951,1,1,1020,1397,377
952,1,0,31,0,-31
953,0,0,106,0,-106
954,1,0,14,0,-14
955,0,0,6,0,-6
956,0,0,125,0,-125
957,1,0,24,0,-24
958,0,0,30,0,-30
959,0,0,58,0,-58
960,0,0,9,0,-9
961,1,1,1202,1927,725
962,1,1,40,1884,1844
963,1,0,20,0,-20
964,0,0,74,0,-74
965,1,1,137,1202,1065
966,1,0,58,0,-58
967,0,0,35,0,-35
968,1,1,322,1251,929
969,0,0,66,0,-66
970,1,1,802,1307,505
971,1,1,1321,1651,330
972,1,0,17,0,-17
973,1,1,850,1410,560
974,0,0,16,0,-16
975,1,0,62,0,-62
976,1,0,112,0,-112
977,1,0,11,0,-11
978,1,0,13,0,-13
979,1,0,26,0,-26
980,1,1,466,1504,1038
981,0,0,45,0,-45
982,1,1,317,1243,926
983,0,0,7,0,-7
984,1,1,721,1364,643
985,1,1,592,1866,1274
986,0,0,34,0,-34
987,0,0,238,0,-238
988,1,1,1107,1440,333
989,0,0,18,0,-18
990,0,0,75,0,-75
991,1,0,44,0,-44
992,0,0,15,0,-15
993,1,0,0,0,0
994,1,1,128,1269,1141
995,1,1,533,1750,1217
996,1,0,7,0,-7
997,0,0,6,0,-6
998,1,1,237,1522,1285
999,0,0,118,0,-118
1000,1,0,19,0,-19
1001,1,0,67,0,-67
1002,1,1,1034,1201,167
1003,0,0,40,0,-40
1004,1,1,392,1311,919
1005,1,0,247,0,-247
1006,1,0,167,0,-167
1007,0,0,30,0,-30
1008,1,1,286,2138,1852
1009,1,0,126,0,-126
1010,1,1,828,1330,502
1011,0,0,25,0,-25
1012,1,0,129,0,-129
1013,0,0,94,0,-94
1014,1,1,474,1463,989
1015,0,0,68,0,-68
1016,0,0,2,0,-2
1017,1,1,2522,1441,-1081
1018,0,0,41,0,-41
1019,0,0,51,0,-51
1020,0,0,4,0,-4
1021,1,1,29,1527,1498
1022,1,0,106,0,-106
1023,1,0,29,0,-29
1024,1,0,30,0,-30
1025,1,1,826,1316,490
1026,1,0,28,0,-28
1027,0,0,59,0,-59
1028,0,0,58,0,-58
1029,1,0,41,0,-41
1030,0,0,6,0,-6
1031,1,1,1128,1248,120
1032,0,0,19,0,-19
1033,0,0,5,0,-5
1034,0,0,17,0,-17
1035,1,0,43,0,-43
1036,0,0,42,0,-42
1037,1,1,613,1667,1054
1038,1,0,13,0,-13
1039,0,0,74,0,-74
1040,0,0,64,0,-64
1041,0,0,0,0,0
1042,0,0,74,0,-74
1043,1,1,122,1400,1278
1044,1,0,5,0,-5
1045,0,0,43,0,-43
1046,0,0,78,0,-78
1047,0,0,27,0,-27
1048,1,0,39,0,-39
1049,0,0,138,0,-138
1050,0,0,203,0,-203
1051,1,1,1800,2878,1078
1052,0,0,52,0,-52
1053,1,1,1088,1527,439
1054,0,0,98,0,-98
1055,1,0,96,0,-96
1056,1,1,384,1603,1219
1057,0,0,13,0,-13
1058,1,0,42,0,-42
1059,0,0,53,0,-53
1060,0,0,134,0,-134
1061,0,0,67,0,-67
1062,0,0,13,0,-13
1063,1,1,611,1477,866
1064,1,1,312,1217,905
1065,1,1,162,1288,1126
1066,1,0,30,0,-30
1067,0,0,62,0,-62
1068,1,0,52,0,-52
1069,0,0,168,0,-168
1070,1,0,47,0,-47
1071,1,0,37,0,-37
1072,1,1,2579,1335,-1244
1073,0,0,15,0,-15
1074,1,1,867,1255,388
1075,1,1,243,2000,1757
1076,0,0,5,0,-5
1077,1,1,119,1939,1820
1078,1,0,191,0,-191
1079,1,0,0,0,0
1080,1,1,621,1222,601
1081,0,0,42,0,-42
1082,1,0,3,0,-3
1083,0,0,56,0,-56
1084,1,0,109,0,-109
1085,1,0,59,0,-59
1086,1,0,113,0,-113
1087,1,1,1735,1224,-511
1088,0,0,374,0,-374
1089,1,0,57,0,-57
1090,0,0,24,0,-24
1091,0,0,39,0,-39
1092,1,1,320,1250,930
1093,1,1,1212,1244,32
1094,1,0,156,0,-156
1095,1,0,65,0,-65
1096,0,0,98,0,-98
1097,1,1,64,1431,1367
1098,1,0,34,0,-34
1099,1,1,307,1962,1655
1100,1,1,546,2012,1466
1101,1,1,174,1300,1126
1102,1,0,13,0,-13
1103,1,0,93,0,-93
1104,0,0,1,0,-1
1105,1,0,87,0,-87
1106,1,1,138,1628,1490
1107,0,0,48,0,-48
1108,0,0,2,0,-2
1109,0,0,49,0,-49
1110,1,0,67,0,-67
1111,0,0,216,0,-216
1112,0,0,38,0,-38
1113,1,0,13,0,-13
1114,1,1,242,1207,965
1115,1,1,379,1242,863
1116,1,0,39,0,-39
1117,0,0,12,0,-12
1118,0,0,0,0,0
1119,1,1,996,1497,501
1120,0,0,35,0,-35
1121,0,0,117,0,-117
1122,0,0,64,0,-64
1123,1,0,107,0,-107
1124,0,0,10,0,-10
1125,0,0,65,0,-65
1126,0,0,1,0,-1
1127,0,0,40,0,-40
1128,1,0,30,0,-30
1129,1,0,147,0,-147
1130,1,1,64,1321,1257
1131,1,1,101,1817,1716
1132,0,0,71,0,-71
1133,1,0,54,0,-54
1134,1,0,15,0,-15
1135,1,1,146,1545,1399
1136,1,0,14,0,-14
1137,1,1,466,1312,846
1138,0,0,73,0,-73
1139,0,0,17,0,-17
1140,0,0,37,0,-37
1141,1,0,4,0,-4
1142,0,0,28,0,-28
1143,0,0,28,0,-28
1144,0,0,37,0,-37
1145,1,0,60,0,-60
1146,1,1,1520,1260,-260
1147,1,1,280,2039,1759
1148,0,0,2,0,-2
1149,1,1,245,1612,1367
1150,0,0,3,0,-3
1151,1,1,407,1519,1112
1152,1,1,424,2211,1787
1153,0,0,61,0,-61
1154,0,0,6,0,-6
1155,1,0,54,0,-54
1156,1,1,1065,1238,173
1157,0,0,44,0,-44
1158,1,0,13,0,-13
1159,0,0,23,0,-23
1160,1,1,1424,1551,127
1161,1,1,1350,1616,266
1162,1,1,70,3011,2941
1163,1,0,114,0,-114
1164,1,1,856,1367,511
1165,1,0,0,0,0
1166,1,1,63,2065,2002
1167,0,0,49,0,-49
1168,1,0,48,0,-48
1169,1,0,161,0,-161
1170,0,0,55,0,-55
1171,0,0,72,0,-72
1172,1,1,548,1269,721
1173,1,0,49,0,-49
1174,1,0,17,0,-17
1175,1,1,2425,1580,-845
1176,1,1,474,1390,916
1177,0,0,42,0,-42
1178,0,0,21,0,-21
1179,0,0,7,0,-7
1180,1,1,418,1219,801
1181,1,1,501,1291,790
1182,1,0,22,0,-22
1183,1,1,45,1938,1893
1184,0,0,28,0,-28
1185,0,0,58,0,-58
1186,0,0,26,0,-26
1187,0,0,92,0,-92
1188,1,0,10,0,-10
1189,1,0,1,0,-1
1190,1,1,448,1422,974
1191,0,0,82,0,-82
1192,0,0,29,0,-29
1193,0,0,3,0,-3
1194,1,0,15,0,-15
1195,1,1,204,1464,1260
1196,1,1,430,1232,802
1197,1,0,16,0,-16
1198,1,1,736,1758,1022
1199,0,0,56,0,-56
1200,0,0,31,0,-31
1201,1,1,146,1867,1721
1202,0,0,23,0,-23
1203,0,0,16,0,-16
1204,0,0,2,0,-2
1205,0,0,194,0,-194
1206,1,0,36,0,-36
1207,1,1,447,1869,1422
1208,0,0,3,0,-3
1209,1,0,61,0,-61
1210,0,0,106,0,-106
1211,1,0,138,0,-138
1212,1,1,281,1990,1709
1213,1,0,22,0,-22
1214,0,0,56,0,-56
1215,1,1,937,1385,448
1216,1,0,115,0,-115
1217,1,1,77,1383,1306
1218,1,0,134,0,-134
1219,0,0,6,0,-6
1220,1,1,783,1625,842
1221,0,0,62,0,-62
1222,1,0,13,0,-13
1223,1,0,271,0,-271
1224,1,0,91,0,-91
1225,1,0,69,0,-69
1226,1,0,20,0,-20
1227,0,0,78,0,-78
1228,0,0,33,0,-33
1229,0,0,28,0,-28
1230,1,0,65,0,-65
1231,1,1,467,1409,942
1232,0,0,48,0,-48
1233,0,0,60,0,-60
1234,1,0,7,0,-7
1235,0,0,22,0,-22
1236,1,1,364,1337,973
1237,1,0,25,0,-25
1238,0,0,29,0,-29
1239,1,0,42,0,-42
1240,0,0,12,0,-12
1241,1,0,47,0,-47
1242,1,1,182,1694,1512
1243,0,0,45,0,-45
1244,1,0,52,0,-52
1245,0,0,169,0,-169
1246,1,1,1276,2769,1493
1247,0,0,41,0,-41
1248,1,0,40,0,-40
1249,1,0,7,0,-7
1250,1,0,16,0,-16
1251,0,0,18,0,-18
1252,1,1,84,2289,2205
1253,0,0,4,0,-4
1254,1,0,33,0,-33
1255,0,0,69,0,-69
1256,1,1,130,1259,1129
1257,1,1,922,1608,686
1258,0,0,27,0,-27
1259,1,1,646,1523,877
1260,1,0,44,0,-44
1261,0,0,118,0,-118
1262,1,0,109,0,-109
1263,1,1,43,1525,1482
1264,1,0,171,0,-171
1265,1,0,28,0,-28
1266,0,0,30,0,-30
1267,1,1,566,2416,1850
1268,1,1,178,1703,1525
1269,1,0,170,0,-170
1270,0,0,7,0,-7
1271,1,0,51,0,-51
1272,1,0,341,0,-341
1273,0,0,6,0,-6
1274,1,0,67,0,-67
1275,1,0,78,0,-78
1276,1,1,276,1421,1145
1277,1,1,352,1749,1397
1278,1,1,715,1332,617
1279,1,0,79,0,-79
1280,1,0,98,0,-98
1281,0,0,39,0,-39
1282,0,0,1,0,-1
1283,1,1,733,1224,491
1284,1,0,10,0,-10
1285,1,0,0,0,0
1286,1,1,245,1718,1473
1287,1,1,1711,1250,-461
1288,1,1,994,1269,275
1289,1,1,860,1655,795
1290,0,0,1,0,-1
1291,1,0,32,0,-32
1292,1,0,39,0,-39
1293,0,0,29,0,-29
1294,1,1,1712,2305,593
1295,1,0,52,0,-52
1296,1,1,372,2270,1898
1297,1,0,44,0,-44
1298,0,0,6,0,-6
1299,1,1,1822,2456,634
1300,1,0,7,0,-7
1301,1,0,36,0,-36
1302,1,0,56,0,-56
1303,1,1,340,1442,1102
1304,1,0,149,0,-149
1305,0,0,2,0,-2
1306,0,0,30,0,-30
1307,0,0,139,0,-139
1308,1,0,89,0,-89
1309,0,0,59,0,-59
1310,1,0,30,0,-30
1311,1,1,932,1275,343
1312,1,0,49,0,-49
1313,1,1,78,2166,2088
1314,1,0,27,0,-27
1315,1,1,138,1633,1495
1316,1,0,115,0,-115
1317,1,0,70,0,-70
1318,1,1,916,1233,317
1319,1,0,21,0,-21
1320,0,0,98,0,-98
1321,1,0,74,0,-74
1322,1,0,96,0,-96
1323,1,1,821,1224,403
1324,0,0,41,0,-41
1325,0,0,17,0,-17
1326,1,0,32,0,-32
1327,1,1,541,1515,974
1328,0,0,80,0,-80
1329,1,0,21,0,-21
1330,0,0,112,0,-112
1331,1,0,164,0,-164
1332,1,0,30,0,-30
1333,1,0,36,0,-36
1334,1,0,84,0,-84
1335,0,0,110,0,-110
1336,0,0,16,0,-16
1337,0,0,9,0,-9
1338,1,1,892,1348,456
1339,1,0,3,0,-3
1340,0,0,121,0,-121
1341,1,1,986,3116,2130
1342,0,0,17,0,-17
1343,1,1,585,2046,1461
1344,0,0,60,0,-60
1345,0,0,9,0,-9
1346,0,0,40,0,-40
1347,1,1,1589,1576,-13
1348,1,0,86,0,-86
1349,1,1,574,1347,773
1350,1,1,785,1318,533
1351,0,0,6,0,-6
1352,0,0,65,0,-65
1353,0,0,26,0,-26
1354,1,0,55,0,-55
1355,1,1,4,1955,1951
1356,0,0,2,0,-2
1357,1,1,417,1577,1160
1358,0,0,1,0,-1
1359,1,1,1132,1296,164
1360,1,0,4,0,-4
1361,1,0,16,0,-16
1362,1,1,192,2689,2497
1363,0,0,40,0,-40
1364,1,0,19,0,-19
1365,1,0,107,0,-107
1366,0,0,194,0,-194
1367,1,1,297,1919,1622
1368,0,0,13,0,-13
1369,0,0,25,0,-25
1370,0,0,4,0,-4
1371,1,1,778,1219,441
1372,0,0,24,0,-24
1373,0,0,1,0,-1
1374,0,0,17,0,-17
1375,1,1,122,1844,1722
1376,0,0,83,0,-83
1377,1,1,603,1389,786
1378,1,0,16,0,-16
1379,1,0,25,0,-25
1380,0,0,18,0,-18
1381,1,0,48,0,-48
1382,0,0,67,0,-67
1383,0,0,23,0,-23
1384,1,1,692,1322,630
1385,1,1,654,1230,576
1386,1,1,945,2355,1410
1387,1,0,23,0,-23
1388,0,0,36,0,-36
1389,0,0,2,0,-2
1390,1,0,6,0,-6
1391,0,0,5,0,-5
1392,0,0,3,0,-3
1393,0,0,2,0,-2
1394,1,1,278,1305,1027
1395,0,0,36,0,-36
1396,0,0,146,0,-146
1397,1,1,188,1400,1212
1398,0,0,16,0,-16
1399,0,0,8,0,-8
1400,1,1,229,2230,2001
1401,0,0,17,0,-17
1402,1,0,30,0,-30
1403,1,0,58,0,-58
1404,1,0,4,0,-4
1405,1,0,79,0,-79
1406,1,0,101,0,-101
1407,1,1,50,1740,1690
1408,0,0,9,0,-9
1409,0,0,48,0,-48
1410,1,1,1716,1349,-367
1411,1,0,102,0,-102
1412,0,0,30,0,-30
1413,0,0,7,0,-7
1414,1,1,56,1300,1244
1415,1,1,321,1501,1180
1416,0,0,6,0,-6
1417,1,1,64,3020,2956
1418,0,0,10,0,-10
1419,0,0,33,0,-33
1420,1,0,25,0,-25
1421,1,1,25,1391,1366
1422,0,0,122,0,-122
1423,0,0,101,0,-101
1424,1,0,2,0,-2
1425,1,0,8,0,-8
1426,1,1,1225,1462,237
1427,1,0,0,0,0
1428,1,1,372,1351,979
1429,0,0,8,0,-8
1430,0,0,113,0,-113
1431,0,0,164,0,-164
1432,1,1,93,1337,1244
1433,1,0,20,0,-20
1434,1,1,168,1218,1050
1435,1,0,3,0,-3
1436,0,0,191,0,-191
1437,0,0,5,0,-5
1438,0,0,16,0,-16
1439,1,0,67,0,-67
1440,0,0,19,0,-19
1441,1,1,138,1355,1217
1442,0,0,19,0,-19
1443,0,0,3,0,-3
1444,1,1,157,1411,1254
1445,0,0,19,0,-19
1446,1,1,507,1524,1017
1447,1,1,417,1207,790
1448,1,0,26,0,-26
1449,1,1,49,1321,1272
1450,0,0,28,0,-28
1451,1,0,115,0,-115
1452,1,0,102,0,-102
1453,1,1,400,1430,1030
1454,1,1,266,1536,1270
1455,1,0,95,0,-95
1456,1,0,26,0,-26
1457,1,1,603,1564,961
1458,1,0,19,0,-19
1459,1,0,173,0,-173
1460,0,0,26,0,-26
1461,1,0,72,0,-72
1462,1,1,499,1684,1185
1463,0,0,72,0,-72
1464,0,0,72,0,-72
1465,0,0,11,0,-11
1466,1,1,973,1685,712
1467,1,0,4,0,-4
1468,0,0,127,0,-127
1469,1,0,2,0,-2
1470,0,0,26,0,-26
1471,1,0,247,0,-247
1472,0,0,106,0,-106
1473,1,0,41,0,-41
1474,1,0,197,0,-197
1475,0,0,128,0,-128
1476,0,0,15,0,-15
1477,1,0,86,0,-86
1478,1,1,23,1445,1422
1479,0,0,33,0,-33
1480,0,0,136,0,-136
1481,0,0,6,0,-6
1482,1,0,15,0,-15
1483,1,0,1,0,-1
1484,1,0,9,0,-9
1485,1,0,40,0,-40
1486,1,1,768,1250,482
1487,0,0,34,0,-34
1488,0,0,0,0,0
1489,0,0,57,0,-57
1490,0,0,15,0,-15
1491,1,0,89,0,-89
1492,0,0,43,0,-43
1493,1,0,21,0,-21
1494,1,1,150,1373,1223
1495,0,0,66,0,-66
1496,1,0,100,0,-100
1497,1,1,186,1662,1476
1498,1,1,776,1322,546
1499,1,1,473,1340,867
1500,0,0,89,0,-89
1501,1,1,94,2190,2096
1502,1,0,40,0,-40
1503,0,0,92,0,-92
1504,1,0,14,0,-14
1505,0,0,27,0,-27
1506,1,1,505,1358,853
1507,1,1,59,1507,1448
1508,1,0,9,0,-9
1509,1,0,98,0,-98
1510,0,0,47,0,-47
1511,0,0,14,0,-14
1512,0,0,167,0,-167
1513,1,1,634,1357,723
1514,1,0,7,0,-7
1515,0,0,67,0,-67
1516,0,0,29,0,-29
1517,0,0,10,0,-10
1518,0,0,99,0,-99
1519,1,1,524,1254,730
1520,1,1,241,1365,1124
1521,1,1,758,1286,528
1522,1,0,128,0,-128
1523,1,0,10,0,-10
1524,0,0,162,0,-162
1525,1,1,1543,1316,-227
1526,1,1,763,1228,465
1527,1,1,636,1223,587
1528,1,0,58,0,-58
1529,1,1,925,1206,281
1530,1,0,1,0,-1
1531,0,0,6,0,-6
1532,1,0,59,0,-59
1533,1,1,482,1325,843
1534,0,0,20,0,-20
1535,1,0,4,0,-4
1536,1,0,115,0,-115
1537,1,1,794,1262,468
1538,1,0,26,0,-26
1539,1,0,67,0,-67
1540,1,1,1429,1364,-65
1541,0,0,13,0,-13
1542,1,1,161,2380,2219
1543,1,1,668,1430,762
1544,1,0,33,0,-33
1545,1,1,153,2189,2036
1546,0,0,7,0,-7
1547,1,1,80,2094,2014
1548,0,0,1,0,-1
1549,1,0,12,0,-12
1550,1,1,493,1306,813
1551,0,0,41,0,-41
1552,1,1,669,1269,600
1553,1,0,123,0,-123
1554,1,1,461,2391,1930
1555,1,1,188,1520,1332
1556,1,0,9,0,-9
1557,0,0,13,0,-13
1558,1,0,30,0,-30
1559,1,1,366,1209,843
1560,0,0,3,0,-3
1561,0,0,73,0,-73
1562,1,0,1,0,-1
1563,1,1,328,1399,1071
1564,1,1,239,1366,1127
1565,1,0,59,0,-59
1566,0,0,13,0,-13
1567,1,1,518,1238,720
1568,1,0,62,0,-62
1569,1,0,38,0,-38
1570,1,1,794,1232,438
1571,1,0,21,0,-21
1572,1,1,617,1569,952
1573,0,0,94,0,-94
1574,0,0,1,0,-1
1575,1,1,134,2143,2009
1576,0,0,96,0,-96
1577,1,1,255,1798,1543
1578,0,0,49,0,-49
1579,0,0,9,0,-9
1580,1,0,22,0,-22
1581,1,1,343,1370,1027
1582,1,1,456,1922,1466
1583,1,1,138,1696,1558
1584,1,1,65,2705,2640
1585,0,0,20,0,-20
1586,0,0,56,0,-56
1587,0,0,5,0,-5
1588,0,0,181,0,-181
1589,1,1,1090,2177,1087
1590,0,0,15,0,-15
1591,0,0,16,0,-16
1592,1,0,29,0,-29
1593,0,0,17,0,-17
1594,0,0,100,0,-100
1595,0,0,25,0,-25
1596,0,0,22,0,-22
1597,1,0,120,0,-120
1598,1,1,307,1419,1112
1599,1,1,804,1311,507
1600,0,0,73,0,-73
1601,0,0,85,0,-85
1602,0,0,30,0,-30
1603,1,0,103,0,-103
1604,1,1,473,1373,900
1605,1,1,1846,1343,-503
1606,0,0,34,0,-34
1607,1,1,969,1354,385
1608,1,1,277,1914,1637
1609,0,0,11,0,-11
1610,1,0,96,0,-96
1611,1,1,127,1203,1076
1612,1,1,247,1564,1317
1613,0,0,31,0,-31
1614,1,0,61,0,-61
1615,0,0,51,0,-51
1616,1,0,68,0,-68
1617,1,1,327,1890,1563
1618,1,1,471,1376,905
1619,1,1,326,1252,926
1620,1,1,119,1533,1414
1621,1,0,10,0,-10
1622,0,0,146,0,-146
1623,1,0,112,0,-112
1624,1,0,38,0,-38
1625,1,1,156,1674,1518
1626,0,0,30,0,-30
1627,1,1,287,1490,1203
1628,1,1,91,1264,1173
1629,0,0,36,0,-36
1630,1,0,106,0,-106
1631,1,0,21,0,-21
1632,1,1,914,1236,322
1633,0,0,6,0,-6
1634,0,0,36,0,-36
1635,0,0,58,0,-58
1636,1,1,332,1451,1119
1637,1,0,4,0,-4
1638,1,1,156,1500,1344
1639,1,0,8,0,-8
1640,1,1,407,1714,1307
1641,0,0,52,0,-52
1642,1,0,16,0,-16
1643,0,0,51,0,-51
1644,1,0,23,0,-23
1645,0,0,141,0,-141
1646,1,0,17,0,-17
1647,0,0,28,0,-28
1648,0,0,28,0,-28
1649,1,0,49,0,-49
1650,1,0,53,0,-53
1651,1,1,282,1479,1197
1652,0,0,86,0,-86
1653,1,0,22,0,-22
1654,1,1,784,1980,1196
1655,0,0,41,0,-41
1656,1,0,9,0,-9
1657,1,1,420,2926,2506
1658,1,1,649,1235,586
1659,0,0,116,0,-116
1660,0,0,57,0,-57
1661,1,1,558,1301,743
1662,1,1,212,1227,1015
1663,1,0,3,0,-3
1664,1,1,435,1278,843
1665,0,0,123,0,-123
1666,1,1,142,1290,1148
1667,1,1,965,2395,1430
1668,0,0,31,0,-31
1669,1,1,401,1932,1531
1670,1,0,6,0,-6
1671,0,0,3,0,-3
1672,0,0,111,0,-111
1673,0,0,2,0,-2
1674,0,0,37,0,-37
1675,1,1,325,1335,1010
1676,1,1,209,1904,1695
1677,1,1,356,2284,1928
1678,1,1,604,1310,706
1679,0,0,1,0,-1
1680,1,1,182,1403,1221
1681,0,0,33,0,-33
1682,1,1,290,1918,1628
1683,0,0,23,0,-23
1684,0,0,68,0,-68
1685,0,0,42,0,-42
1686,1,0,22,0,-22
1687,0,0,3,0,-3
1688,0,0,8,0,-8
1689,1,0,16,0,-16
1690,1,0,11,0,-11
1691,0,0,72,0,-72
1692,1,0,3,0,-3
1693,0,0,91,0,-91
1694,0,0,46,0,-46
1695,0,0,32,0,-32
1696,1,0,108,0,-108
1697,0,0,52,0,-52
1698,1,0,42,0,-42
1699,0,0,27,0,-27
1700,1,1,276,1304,1028
1701,0,0,95,0,-95
1702,1,0,9,0,-9
1703,1,1,423,1386,963
1704,0,0,10,0,-10
1705,1,0,5,0,-5
1706,1,0,14,0,-14
1707,1,1,75,1257,1182
1708,1,0,90,0,-90
1709,0,0,44,0,-44
1710,1,1,250,1702,1452
1711,1,0,109,0,-109
1712,1,1,1313,1447,134
1713,0,0,49,0,-49
1714,1,0,82,0,-82
1715,0,0,13,0,-13
1716,1,1,228,1222,994
1717,1,1,190,1998,1808
1718,0,0,8,0,-8
1719,0,0,21,0,-21
1720,1,0,5,0,-5
1721,1,0,99,0,-99
1722,1,1,145,1239,1094
1723,1,0,79,0,-79
1724,0,0,238,0,-238
1725,1,1,160,1560,1400
1726,0,0,69,0,-69
1727,1,1,471,1557,1086
1728,1,1,324,1425,1101
1729,1,1,245,1501,1256
1730,1,0,29,0,-29
1731,1,0,10,0,-10
1732,1,0,51,0,-51
1733,1,1,95,1652,1557
1734,1,0,65,0,-65
1735,1,1,399,2065,1666
1736,1,1,83,1237,1154
1737,0,0,44,0,-44
1738,0,0,29,0,-29
1739,1,1,90,1203,1113
1740,1,1,299,1684,1385
1741,0,0,78,0,-78
1742,1,0,89,0,-89
1743,0,0,0,0,0
1744,0,0,12,0,-12
1745,0,0,40,0,-40
1746,1,0,12,0,-12
1747,1,1,1958,1306,-652
1748,0,0,17,0,-17
1749,1,0,34,0,-34
1750,1,1,172,1426,1254
1751,1,1,148,1685,1537
1752,1,1,44,1425,1381
1753,0,0,84,0,-84
1754,1,1,194,1326,1132
1755,0,0,3,0,-3
1756,1,0,57,0,-57
1757,1,0,6,0,-6
1758,1,0,4,0,-4
1759,1,1,575,1260,685
1760,0,0,40,0,-40
1761,1,1,1434,1444,10
1762,0,0,12,0,-12
1763,0,0,22,0,-22
1764,1,0,23,0,-23
1765,0,0,41,0,-41
1766,0,0,6,0,-6
1767,1,0,17,0,-17
1768,0,0,23,0,-23
1769,1,1,165,1542,1377
1770,0,0,32,0,-32
1771,0,0,46,0,-46
1772,1,1,2027,1424,-603
1773,0,0,33,0,-33
1774,0,0,7,0,-7
1775,0,0,23,0,-23
1776,1,0,73,0,-73
1777,1,0,80,0,-80
1778,1,0,87,0,-87
1779,1,1,710,1262,552
1780,0,0,19,0,-19
1781,1,1,946,2389,1443
1782,1,0,14,0,-14
1783,1,0,26,0,-26
1784,1,1,442,2322,1880
1785,1,0,35,0,-35
1786,1,1,2098,1335,-763
1787,0,0,45,0,-45
1788,1,1,210,1633,1423
1789,0,0,36,0,-36
1790,0,0,91,0,-91
1791,1,1,964,1223,259
1792,1,1,200,1258,1058
1793,0,0,87,0,-87
1794,1,0,8,0,-8
1795,1,0,16,0,-16
1796,1,1,193,1785,1592
1797,1,1,1044,1984,940
1798,1,1,169,1293,1124
1799,0,0,1,0,-1
1800,0,0,61,0,-61
1801,1,0,16,0,-16
1802,1,1,330,1320,990
1803,0,0,114,0,-114
1804,1,0,6,0,-6
1805,0,0,59,0,-59
1806,1,0,38,0,-38
1807,1,0,85,0,-85
1808,0,0,31,0,-31
1809,0,0,34,0,-34
1810,0,0,0,0,0
1811,1,0,4,0,-4
1812,0,0,10,0,-10
1813,1,1,470,1242,772
1814,1,1,194,1289,1095
1815,1,0,12,0,-12
1816,0,0,10,0,-10
1817,1,1,927,1817,890
1818,1,1,2078,1611,-467
1819,0,0,27,0,-27
1820,1,0,33,0,-33
1821,0,0,7,0,-7
1822,1,0,71,0,-71
1823,1,0,94,0,-94
1824,1,0,74,0,-74
1825,0,0,21,0,-21
1826,1,1,218,1583,1365
1827,1,1,119,1481,1362
1828,1,1,734,1485,751
1829,1,0,67,0,-67
1830,1,1,85,1902,1817
1831,1,0,58,0,-58
1832,0,0,122,0,-122
1833,1,0,9,0,-9
1834,1,0,19,0,-19
1835,1,1,1247,1291,44
1836,1,0,4,0,-4
1837,0,0,71,0,-71
1838,1,0,13,0,-13
1839,0,0,49,0,-49
1840,1,1,215,2365,2150
1841,1,1,1826,1302,-524
1842,1,1,442,1336,894
1843,0,0,32,0,-32
1844,0,0,26,0,-26
1845,1,1,583,1308,725
1846,1,0,23,0,-23
1847,1,1,827,1432,605
1848,0,0,1,0,-1
1849,0,0,69,0,-69
1850,0,0,21,0,-21
1851,0,0,17,0,-17
1852,1,0,45,0,-45
1853,0,0,165,0,-165
1854,1,0,29,0,-29
1855,1,1,37,2272,2235
1856,1,1,672,1598,926
1857,1,0,21,0,-21
1858,0,0,1,0,-1
1859,0,0,82,0,-82
1860,1,0,3,0,-3
1861,0,0,32,0,-32
1862,1,0,58,0,-58
1863,1,0,50,0,-50
1864,1,1,1083,1289,206
1865,1,0,68,0,-68
1866,1,0,134,0,-134
1867,0,0,1,0,-1
1868,0,0,14,0,-14
1869,0,0,12,0,-12
1870,1,1,633,1226,593
1871,1,1,132,1298,1166
1872,1,0,18,0,-18
1873,1,1,45,1794,1749
1874,1,1,352,2007,1655
1875,0,0,6,0,-6
1876,0,0,60,0,-60
1877,1,1,110,1242,1132
1878,0,0,40,0,-40
1879,1,1,44,1221,1177
1880,1,1,511,1865,1354
1881,0,0,13,0,-13
1882,0,0,14,0,-14
1883,1,1,230,1503,1273
1884,0,0,121,0,-121
1885,0,0,30,0,-30
1886,1,0,32,0,-32
1887,1,1,310,1251,941
1888,0,0,64,0,-64
1889,0,0,54,0,-54
1890,1,1,331,1551,1220
1891,0,0,2,0,-2
1892,0,0,50,0,-50
1893,1,0,116,0,-116
1894,1,0,117,0,-117
1895,1,1,839,1219,380
1896,1,1,659,1320,661
1897,1,0,120,0,-120
1898,0,0,8,0,-8
1899,0,0,51,0,-51
1900,1,1,421,1439,1018
1901,0,0,143,0,-143
1902,0,0,4,0,-4
1903,1,1,212,3994,3782
1904,0,0,52,0,-52
1905,1,0,35,0,-35
1906,1,0,49,0,-49
1907,1,0,41,0,-41
1908,1,1,647,1275,628
1909,1,0,23,0,-23
1910,1,1,795,1202,407
1911,0,0,15,0,-15
1912,1,1,708,2013,1305
1913,0,0,8,0,-8
1914,1,0,4,0,-4
1915,1,0,39,0,-39
1916,1,1,1323,1339,16
1917,1,1,462,1485,1023
1918,0,0,26,0,-26
1919,1,0,37,0,-37
1920,0,0,1,0,-1
1921,0,0,175,0,-175
1922,0,0,5,0,-5
1923,0,0,36,0,-36
1924,0,0,4,0,-4
1925,0,0,62,0,-62
1926,1,0,56,0,-56
1927,1,1,973,1297,324
1928,1,0,34,0,-34
1929,1,0,23,0,-23
1930,1,1,420,4180,3760
1931,1,0,12,0,-12
1932,1,1,93,1542,1449
1933,1,0,171,0,-171
1934,1,1,194,2197,2003
1935,0,0,92,0,-92
1936,1,0,78,0,-78
1937,1,1,258,1512,1254
1938,0,0,29,0,-29
1939,1,1,733,1730,997
1940,0,0,10,0,-10
1941,1,1,275,2180,1905
1942,1,1,1459,1820,361
1943,1,0,27,0,-27
1944,1,0,3,0,-3
1945,1,1,2762,5325,2563
1946,1,1,704,2412,1708
1947,1,0,39,0,-39
1948,1,1,383,1433,1050
1949,1,1,142,1468,1326
1950,0,0,44,0,-44
1951,0,0,190,0,-190
1952,1,0,39,0,-39
1953,1,0,163,0,-163
1954,1,1,573,1493,920
1955,1,0,79,0,-79
1956,1,0,92,0,-92
1957,1,0,16,0,-16
1958,1,1,254,1214,960
1959,1,0,17,0,-17
1960,1,1,348,2018,1670
1961,1,1,451,1247,796
1962,0,0,84,0,-84
1963,1,1,326,1460,1134
1964,0,0,12,0,-12
1965,1,0,43,0,-43
1966,1,1,458,1590,1132
1967,1,0,22,0,-22
1968,0,0,84,0,-84
1969,1,1,785,1291,506
1970,1,1,934,1246,312
1971,1,0,13,0,-13
1972,0,0,51,0,-51
1973,1,1,308,1236,928
1974,1,0,30,0,-30
1975,1,1,580,1359,779
1976,0,0,114,0,-114
1977,0,0,31,0,-31
1978,1,0,61,0,-61
1979,1,0,19,0,-19
1980,0,0,35,0,-35
1981,1,1,987,1273,286
1982,1,0,10,0,-10
1983,1,0,14,0,-14
1984,1,1,1325,1287,-38
1985,0,0,98,0,-98
1986,1,0,148,0,-148
1987,1,1,54,1468,1414
1988,0,0,49,0,-49
1989,0,0,26,0,-26
1990,0,0,0,0,0
1991,1,1,981,2345,1364
1992,0,0,48,0,-48
1993,1,0,22,0,-22
1994,1,1,132,1531,1399
1995,1,0,36,0,-36
1996,1,0,17,0,-17
1997,0,0,33,0,-33
1998,1,1,651,1444,793
1999,0,0,0,0,0
2000,1,0,57,0,-57
2001,0,0,32,0,-32
2002,1,1,285,2082,1797
2003,0,0,75,0,-75
2004,1,0,0,0,0
2005,0,0,54,0,-54
2006,1,1,67,1487,1420
2007,0,0,109,0,-109
2008,1,0,123,0,-123
2009,0,0,116,0,-116
2010,0,0,4,0,-4
2011,1,0,33,0,-33
2012,1,0,102,0,-102
2013,0,0,78,0,-78
2014,1,1,1004,1313,309
2015,0,0,113,0,-113
2016,1,1,82,1557,1475
2017,1,1,1286,1279,-7
2018,1,1,123,1239,1116
2019,1,1,231,1680,1449
2020,0,0,8,0,-8
2021,1,1,756,1819,1063
2022,0,0,42,0,-42
2023,0,0,27,0,-27
2024,1,1,159,2543,2384
2025,0,0,29,0,-29
2026,1,0,117,0,-117
2027,1,1,222,1386,1164
2028,0,0,67,0,-67
2029,0,0,19,0,-19
2030,0,0,53,0,-53
2031,1,0,32,0,-32
2032,0,0,27,0,-27
2033,1,0,68,0,-68
2034,1,1,173,1232,1059
2035,1,1,474,1397,923
2036,1,0,0,0,0
2037,1,1,403,2420,2017
2038,1,0,109,0,-109
2039,1,0,7,0,-7
2040,1,0,0,0,0
2041,1,0,21,0,-21
2042,1,0,32,0,-32
2043,0,0,6,0,-6
2044,1,0,95,0,-95
2045,1,1,203,1289,1086
2046,1,1,209,1985,1776
2047,1,0,101,0,-101
2048,1,0,1,0,-1
2049,1,0,40,0,-40
2050,0,0,106,0,-106
2051,0,0,54,0,-54
2052,1,1,1033,2415,1382
2053,1,1,494,1414,920
2054,1,1,1904,1856,-48
2055,1,1,972,1275,303
2056,1,0,43,0,-43
2057,1,1,829,2140,1311
2058,1,0,62,0,-62
2059,1,0,68,0,-68
2060,1,1,144,3711,3567
2061,1,0,12,0,-12
2062,0,0,140,0,-140
2063,0,0,50,0,-50
2064,1,1,230,1587,1357
2065,0,0,93,0,-93
2066,1,0,50,0,-50
2067,0,0,32,0,-32
2068,1,1,290,1573,1283
2069,1,0,4,0,-4
2070,1,0,206,0,-206
2071,0,0,17,0,-17
2072,1,0,17,0,-17
2073,0,0,13,0,-13
2074,1,1,316,1935,1619
2075,1,0,25,0,-25
2076,0,0,111,0,-111
2077,1,0,17,0,-17
2078,0,0,18,0,-18
2079,0,0,23,0,-23
2080,1,0,21,0,-21
2081,0,0,30,0,-30
2082,0,0,6,0,-6
2083,1,1,1339,1543,204
2084,1,0,89,0,-89
2085,1,0,11,0,-11
2086,0,0,20,0,-20
2087,1,0,33,0,-33
2088,0,0,2,0,-2
2089,1,1,960,1324,364
2090,0,0,39,0,-39
2091,1,0,253,0,-253
2092,1,1,293,1231,938
2093,0,0,89,0,-89
2094,0,0,17,0,-17
2095,0,0,26,0,-26
2096,0,0,20,0,-20
2097,1,0,299,0,-299
2098,0,0,48,0,-48
2099,1,1,240,1373,1133
2100,1,0,104,0,-104
2101,1,1,2322,2018,-304
2102,0,0,47,0,-47
2103,0,0,28,0,-28
2104,0,0,3,0,-3
2105,1,1,508,4672,4164
2106,0,0,144,0,-144
2107,1,0,6,0,-6
2108,0,0,78,0,-78
2109,1,1,188,1362,1174
2110,0,0,4,0,-4
2111,0,0,71,0,-71
2112,0,0,111,0,-111
2113,0,0,77,0,-77
2114,1,0,87,0,-87
2115,0,0,57,0,-57
2116,0,0,8,0,-8
2117,1,1,170,1307,1137
2118,1,0,47,0,-47
2119,0,0,23,0,-23
2120,1,0,27,0,-27
2121,1,1,1571,1719,148
2122,1,1,380,1204,824
2123,1,1,1650,1272,-378
2124,1,0,16,0,-16
2125,1,1,202,1686,1484
2126,1,1,803,1309,506
2127,1,0,14,0,-14
2128,1,0,100,0,-100
2129,0,0,8,0,-8
2130,1,0,30,0,-30
2131,1,1,287,1232,945
2132,1,1,97,1323,1226
2133,1,0,24,0,-24
2134,0,0,2,0,-2
2135,1,1,205,1328,1123
2136,1,1,690,1485,795
2137,0,0,52,0,-52
2138,0,0,222,0,-222
2139,1,0,228,0,-228
2140,0,0,118,0,-118
2141,1,0,0,0,0
2142,0,0,33,0,-33
2143,1,0,2,0,-2
2144,0,0,177,0,-177
2145,1,0,18,0,-18
2146,0,0,25,0,-25
2147,0,0,1,0,-1
2148,0,0,81,0,-81
2149,0,0,44,0,-44
2150,0,0,59,0,-59
2151,0,0,4,0,-4
2152,0,0,154,0,-154
2153,1,1,216,1352,1136
2154,0,0,7,0,-7
2155,1,0,54,0,-54
2156,0,0,73,0,-73
2157,0,0,11,0,-11
2158,0,0,4,0,-4
2159,0,0,3,0,-3
2160,0,0,41,0,-41
2161,0,0,62,0,-62
2162,1,1,47,1241,1194
2163,1,0,11,0,-11
2164,0,0,36,0,-36
2165,0,0,10,0,-10
2166,1,1,88,1506,1418
2167,1,0,68,0,-68
2168,0,0,8,0,-8
2169,1,0,97,0,-97
2170,1,0,9,0,-9
2171,0,0,4,0,-4
2172,0,0,17,0,-17
2173,0,0,9,0,-9
2174,1,1,163,1448,1285
2175,1,1,241,1597,1356
2176,0,0,41,0,-41
2177,0,0,32,0,-32
2178,1,1,772,1845,1073
2179,1,0,171,0,-171
2180,0,0,11,0,-11
2181,1,0,37,0,-37
2182,0,0,100,0,-100
2183,1,1,226,1482,1256
2184,0,0,27,0,-27
2185,0,0,82,0,-82
2186,1,0,43,0,-43
2187,0,0,96,0,-96
2188,1,0,25,0,-25
2189,0,0,40,0,-40
2190,1,1,642,1947,1305
2191,0,0,41,0,-41
2192,1,0,73,0,-73
2193,1,1,738,1543,805
2194,1,0,16,0,-16
2195,0,0,32,0,-32
2196,1,0,20,0,-20
2197,1,0,32,0,-32
2198,1,0,156,0,-156
2199,1,1,458,2392,1934
2200,0,0,116,0,-116
2201,1,1,342,1373,1031
2202,1,0,3,0,-3
2203,0,0,43,0,-43
2204,1,1,558,2153,1595
2205,1,0,1,0,-1
2206,0,0,75,0,-75
2207,1,0,38,0,-38
2208,0,0,163,0,-163
2209,0,0,56,0,-56
2210,0,0,24,0,-24
2211,1,0,22,0,-22
2212,0,0,43,0,-43
2213,0,0,3,0,-3
2214,1,1,143,1492,1349
2215,1,1,158,1240,1082
2216,0,0,31,0,-31
2217,1,1,600,1756,1156
2218,1,0,26,0,-26
2219,1,1,1067,1470,403
2220,1,0,17,0,-17
2221,1,1,224,1218,994
2222,0,0,119,0,-119
2223,1,0,85,0,-85
2224,0,0,71,0,-71
2225,0,0,53,0,-53
2226,1,0,27,0,-27
2227,0,0,61,0,-61
2228,0,0,33,0,-33
2229,1,0,65,0,-65
2230,1,1,337,1680,1343
2231,0,0,2,0,-2
2232,0,0,123,0,-123
2233,1,1,1108,1212,104
2234,1,1,642,1294,652
2235,0,0,28,0,-28
2236,1,0,24,0,-24
2237,0,0,106,0,-106
2238,1,1,478,2469,1991
2239,1,0,5,0,-5
2240,0,0,13,0,-13
2241,1,1,14,2724,2710
2242,1,1,1967,1288,-679
2243,0,0,13,0,-13
2244,0,0,8,0,-8
2245,1,0,14,0,-14
2246,0,0,10,0,-10
2247,0,0,28,0,-28
2248,0,0,18,0,-18
2249,0,0,8,0,-8
2250,0,0,17,0,-17
2251,1,1,818,1659,841
2252,1,0,7,0,-7
2253,0,0,14,0,-14
2254,1,1,303,1378,1075
2255,0,0,70,0,-70
2256,1,1,42,1631,1589
2257,0,0,74,0,-74
2258,0,0,103,0,-103
2259,0,0,12,0,-12
2260,0,0,102,0,-102
2261,1,1,354,1403,1049
2262,0,0,2,0,-2
2263,1,1,220,1724,1504
2264,1,0,103,0,-103
2265,1,1,313,1527,1214
2266,1,1,97,1902,1805
2267,0,0,13,0,-13
2268,0,0,157,0,-157
2269,1,0,42,0,-42
2270,0,0,109,0,-109
2271,0,0,14,0,-14
2272,1,0,27,0,-27
2273,1,1,372,1853,1481
2274,0,0,10,0,-10
2275,0,0,69,0,-69
2276,1,0,56,0,-56
2277,0,0,25,0,-25
2278,1,1,200,4072,3872
2279,1,1,1632,1669,37
2280,0,0,39,0,-39
2281,0,0,182,0,-182
2282,0,0,8,0,-8
2283,1,1,87,3369,3282
2284,1,1,364,1404,1040
2285,1,0,17,0,-17
2286,1,0,312,0,-312
2287,1,0,68,0,-68
2288,1,0,101,0,-101
2289,0,0,6,0,-6
2290,1,1,1165,1350,185
2291,1,1,93,1672,1579
2292,1,0,90,0,-90
2293,0,0,48,0,-48
2294,0,0,32,0,-32
2295,1,1,94,1308,1214
2296,0,0,21,0,-21
2297,0,0,11,0,-11
2298,1,0,55,0,-55
2299,0,0,42,0,-42
2300,1,0,123,0,-123
2301,1,1,255,6558,6303
2302,1,0,21,0,-21
2303,1,0,70,0,-70
2304,1,1,215,1204,989
2305,1,0,11,0,-11
2306,0,0,39,0,-39
2307,0,0,2,0,-2
2308,1,0,34,0,-34
2309,1,0,26,0,-26
2310,1,0,71,0,-71
2311,1,0,4,0,-4
2312,1,0,90,0,-90
2313,1,1,1871,1887,16
2314,1,0,59,0,-59
2315,1,1,1308,1307,-1
2316,0,0,50,0,-50
2317,1,0,89,0,-89
2318,0,0,148,0,-148
2319,0,0,10,0,-10
2320,1,0,21,0,-21
2321,1,0,26,0,-26
2322,0,0,126,0,-126
2323,1,0,10,0,-10
2324,1,0,22,0,-22
2325,1,1,855,1339,484
2326,0,0,144,0,-144
2327,0,0,2,0,-2
2328,0,0,19,0,-19
2329,1,0,37,0,-37
2330,0,0,99,0,-99
2331,1,0,116,0,-116
2332,0,0,33,0,-33
2333,0,0,1,0,-1
2334,0,0,19,0,-19
2335,0,0,30,0,-30
2336,1,0,18,0,-18
2337,0,0,103,0,-103
2338,1,1,121,1332,1211
2339,1,0,31,0,-31
2340,0,0,6,0,-6
2341,0,0,65,0,-65
2342,1,1,368,1297,929
2343,1,0,14,0,-14
2344,0,0,18,0,-18
2345,1,1,566,1856,1290
2346,0,0,18,0,-18
2347,1,1,35,1299,1264
2348,0,0,12,0,-12
2349,1,0,80,0,-80
2350,0,0,72,0,-72
2351,1,0,64,0,-64
2352,0,0,19,0,-19
2353,1,0,20,0,-20
2354,1,1,38,1497,1459
2355,1,0,262,0,-262
2356,1,1,40,1213,1173
2357,0,0,6,0,-6
2358,1,0,114,0,-114
2359,0,0,123,0,-123
2360,0,0,71,0,-71
2361,1,0,3,0,-3
2362,1,1,1123,1271,148
2363,0,0,11,0,-11
2364,0,0,27,0,-27
2365,0,0,25,0,-25
2366,0,0,75,0,-75
2367,0,0,29,0,-29
2368,0,0,156,0,-156
2369,0,0,25,0,-25
2370,1,1,156,1580,1424
2371,1,1,265,1272,1007
2372,1,0,47,0,-47
2373,0,0,54,0,-54
2374,1,0,9,0,-9
2375,0,0,4,0,-4
2376,1,1,879,1751,872
2377,0,0,28,0,-28
2378,1,0,29,0,-29
2379,1,1,223,1200,977
2380,0,0,28,0,-28
2381,0,0,60,0,-60
2382,1,1,994,1358,364
2383,1,1,183,1400,1217
2384,1,1,112,1336,1224
2385,0,0,50,0,-50
2386,1,1,635,1361,726
2387,1,1,401,1232,831
2388,0,0,29,0,-29
2389,1,1,1582,1377,-205
2390,1,1,231,2081,1850
2391,1,1,267,1530,1263
2392,0,0,6,0,-6
2393,0,0,54,0,-54
2394,1,1,1114,1846,732
2395,1,0,29,0,-29
2396,1,0,6,0,-6
2397,1,1,610,1298,688
2398,1,1,525,1282,757
2399,0,0,14,0,-14
2400,0,0,0,0,0
2401,1,0,15,0,-15
2402,1,1,224,1668,1444
2403,1,1,154,1758,1604
2404,1,0,27,0,-27
2405,0,0,17,0,-17
2406,1,0,16,0,-16
2407,1,0,37,0,-37
2408,0,0,78,0,-78
2409,1,1,96,1484,1388
2410,0,0,6,0,-6
2411,1,1,1148,1780,632
2412,0,0,148,0,-148
2413,1,0,8,0,-8
2414,1,1,544,1215,671
2415,0,0,13,0,-13
2416,0,0,50,0,-50
2417,0,0,72,0,-72
2418,1,1,781,1882,1101
2419,0,0,89,0,-89
2420,1,1,165,1532,1367
2421,1,0,46,0,-46
2422,1,1,878,1384,506
2423,0,0,12,0,-12
2424,1,0,8,0,-8
2425,1,1,762,1268,506
2426,1,1,235,1283,1048
2427,1,0,27,0,-27
2428,1,0,37,0,-37
2429,1,0,47,0,-47
2430,0,0,159,0,-159
2431,1,1,512,1317,805
2432,0,0,11,0,-11
2433,1,0,141,0,-141
2434,0,0,43,0,-43
2435,0,0,5,0,-5
2436,1,1,419,2100,1681
2437,1,1,579,1465,886
2438,1,1,1143,1588,445
2439,1,1,651,3076,2425
2440,0,0,58,0,-58
2441,1,0,121,0,-121
2442,1,0,116,0,-116
2443,1,0,33,0,-33
2444,0,0,109,0,-109
2445,1,0,5,0,-5
2446,1,0,3,0,-3
2447,1,0,94,0,-94
2448,1,0,1,0,-1
2449,0,0,5,0,-5
2450,0,0,8,0,-8
2451,0,0,18,0,-18
2452,0,0,35,0,-35
2453,1,1,301,1309,1008
2454,0,0,12,0,-12
2455,0,0,76,0,-76
2456,1,1,491,1852,1361
2457,1,0,26,0,-26
2458,0,0,10,0,-10
2459,0,0,12,0,-12
2460,1,0,37,0,-37
2461,1,1,913,1549,636
2462,0,0,9,0,-9
2463,0,0,8,0,-8
2464,1,1,423,2099,1676
2465,0,0,25,0,-25
2466,0,0,4,0,-4
2467,0,0,0,0,0
2468,1,0,51,0,-51
2469,1,0,33,0,-33
2470,1,1,532,4533,4001
2471,0,0,31,0,-31
2472,1,1,1048,1661,613
2473,0,0,104,0,-104
2474,0,0,8,0,-8
2475,0,0,2,0,-2
2476,0,0,84,0,-84
2477,1,0,25,0,-25
2478,1,0,18,0,-18
2479,1,1,169,1277,1108
2480,0,0,20,0,-20
2481,1,0,77,0,-77
2482,1,1,1982,1378,-604
2483,1,1,725,4369,3644
2484,0,0,10,0,-10
2485,1,0,43,0,-43
2486,1,0,33,0,-33
2487,1,0,27,0,-27
2488,0,0,122,0,-122
2489,0,0,68,0,-68
2490,0,0,88,0,-88
2491,1,0,5,0,-5
2492,0,0,42,0,-42
2493,0,0,1,0,-1
2494,0,0,4,0,-4
2495,1,0,65,0,-65
2496,0,0,50,0,-50
2497,1,0,63,0,-63
2498,0,0,20,0,-20
2499,0,0,140,0,-140
2500,0,0,8,0,-8
2501,0,0,38,0,-38
2502,0,0,11,0,-11
2503,1,1,59,1275,1216
2504,0,0,134,0,-134
2505,1,1,142,1655,1513
2506,1,1,117,1517,1400
2507,1,1,262,1289,1027
2508,0,0,89,0,-89
2509,1,0,1,0,-1
2510,0,0,87,0,-87
2511,1,1,628,1511,883
2512,1,0,86,0,-86
2513,0,0,122,0,-122
2514,0,0,20,0,-20
2515,0,0,74,0,-74
2516,0,0,111,0,-111
2517,1,0,63,0,-63
2518,1,0,34,0,-34
2519,0,0,18,0,-18
2520,1,1,419,1532,1113
2521,1,1,461,1383,922
2522,1,0,41,0,-41
2523,1,0,95,0,-95
2524,1,0,30,0,-30
2525,1,1,2400,1644,-756
2526,1,1,103,1923,1820
2527,0,0,21,0,-21
2528,1,0,119,0,-119
2529,1,1,941,1339,398
2530,0,0,168,0,-168
2531,1,0,62,0,-62
2532,1,0,36,0,-36
2533,0,0,42,0,-42
2534,1,1,760,1749,989
2535,0,0,100,0,-100
2536,1,0,49,0,-49
2537,1,1,381,1281,900
2538,1,1,452,1262,810
2539,1,0,37,0,-37
2540,0,0,10,0,-10
2541,0,0,68,0,-68
2542,1,1,162,1337,1175
2543,0,0,23,0,-23
2544,0,0,20,0,-20
2545,1,1,316,1419,1103
2546,1,1,1236,1215,-21
2547,0,0,89,0,-89
2548,0,0,21,0,-21
2549,0,0,12,0,-12
2550,1,1,771,1368,597
2551,1,0,9,0,-9
2552,1,1,364,1793,1429
2553,0,0,30,0,-30
2554,0,0,64,0,-64
2555,1,0,35,0,-35
2556,0,0,85,0,-85
2557,1,0,97,0,-97
2558,0,0,18,0,-18
2559,1,0,41,0,-41
2560,1,1,486,1990,1504
2561,1,0,2,0,-2
2562,1,0,20,0,-20
2563,1,0,28,0,-28
2564,1,1,649,1522,873
2565,0,0,24,0,-24
2566,1,0,67,0,-67
2567,0,0,40,0,-40
2568,1,0,60,0,-60
2569,0,0,171,0,-171
2570,1,0,0,0,0
2571,1,0,49,0,-49
2572,1,0,84,0,-84
2573,1,1,284,1624,1340
2574,1,0,28,0,-28
2575,1,0,24,0,-24
2576,1,0,7,0,-7
2577,0,0,25,0,-25
2578,1,0,78,0,-78
2579,1,0,41,0,-41
2580,1,0,60,0,-60
2581,0,0,155,0,-155
2582,0,0,3,0,-3
2583,1,1,222,1288,1066
2584,0,0,17,0,-17
2585,0,0,114,0,-114
2586,0,0,14,0,-14
2587,0,0,62,0,-62
2588,1,0,191,0,-191
2589,0,0,19,0,-19
2590,1,1,277,1315,1038
2591,1,1,468,1984,1516
2592,0,0,7,0,-7
2593,0,0,61,0,-61
2594,0,0,47,0,-47
2595,1,0,6,0,-6
2596,1,0,31,0,-31
2597,1,1,317,1714,1397
2598,0,0,26,0,-26
2599,0,0,28,0,-28
2600,1,0,28,0,-28
2601,0,0,34,0,-34
2602,0,0,7,0,-7
2603,1,0,5,0,-5
2604,0,0,6,0,-6
2605,1,1,534,2322,1788
2606,1,0,23,0,-23
2607,0,0,23,0,-23
2608,0,0,7,0,-7
2609,1,1,791,1248,457
2610,1,1,704,1397,693
2611,1,1,441,1452,1011
2612,1,0,25,0,-25
2613,0,0,29,0,-29
2614,0,0,38,0,-38
2615,0,0,31,0,-31
2616,0,0,21,0,-21
2617,0,0,37,0,-37
2618,0,0,9,0,-9
2619,1,0,18,0,-18
2620,0,0,208,0,-208
2621,1,1,53,2222,2169
2622,0,0,107,0,-107
2623,1,0,20,0,-20
2624,1,1,99,1348,1249
2625,1,1,1310,1346,36
2626,1,1,368,1824,1456
2627,0,0,16,0,-16
2628,1,0,0,0,0
2629,0,0,11,0,-11
2630,1,1,834,1550,716
2631,0,0,49,0,-49
2632,0,0,11,0,-11
2633,0,0,53,0,-53
2634,1,1,850,1294,444
2635,0,0,31,0,-31
2636,1,0,76,0,-76
2637,1,1,581,1456,875
2638,0,0,231,0,-231
2639,1,1,243,1413,1170
2640,0,0,1,0,-1
2641,1,0,16,0,-16
2642,1,1,1205,1510,305
2643,1,0,21,0,-21
2644,1,1,235,1350,1115
2645,1,0,5,0,-5
2646,0,0,115,0,-115
2647,0,0,27,0,-27
2648,1,0,37,0,-37
2649,0,0,71,0,-71
2650,1,1,484,1214,730
2651,0,0,1,0,-1
2652,0,0,150,0,-150
2653,0,0,29,0,-29
2654,1,1,459,2045,1586
2655,0,0,77,0,-77
2656,0,0,8,0,-8
2657,1,1,155,1844,1689
2658,0,0,0,0,0
2659,0,0,7,0,-7
2660,0,0,165,0,-165
2661,1,0,29,0,-29
2662,1,1,538,1229,691
2663,0,0,39,0,-39
2664,1,0,20,0,-20
2665,1,0,26,0,-26
2666,0,0,50,0,-50
2667,0,0,15,0,-15
2668,1,1,1079,1397,318
2669,1,1,43,1306,1263
2670,1,1,1760,1696,-64
2671,1,1,350,1669,1319
2672,0,0,56,0,-56
2673,0,0,72,0,-72
2674,1,0,168,0,-168
2675,1,0,25,0,-25
2676,1,1,458,1860,1402
2677,1,0,59,0,-59
2678,1,1,1172,1328,156
2679,1,0,5,0,-5
2680,1,1,493,1308,815
2681,1,1,47,1401,1354
2682,0,0,50,0,-50
2683,0,0,24,0,-24
2684,0,0,4,0,-4
2685,0,0,27,0,-27
2686,1,0,20,0,-20
2687,1,1,599,1321,722
2688,1,1,392,1243,851
2689,0,0,148,0,-148
2690,0,0,22,0,-22
2691,1,0,15,0,-15
2692,1,1,172,1633,1461
2693,0,0,52,0,-52
2694,1,1,2182,1251,-931
2695,1,0,79,0,-79
2696,1,1,429,1632,1203
2697,0,0,11,0,-11
2698,1,1,316,1494,1178
2699,0,0,86,0,-86
2700,0,0,31,0,-31
2701,1,1,455,1212,757
2702,1,0,134,0,-134
2703,1,0,43,0,-43
2704,0,0,8,0,-8
2705,1,0,25,0,-25
2706,1,0,14,0,-14
2707,1,0,6,0,-6
2708,1,0,26,0,-26
2709,0,0,31,0,-31
2710,0,0,228,0,-228
2711,1,0,26,0,-26
2712,1,1,783,2054,1271
2713,0,0,6,0,-6
2714,1,0,22,0,-22
2715,1,1,1057,1388,331
2716,1,1,424,1336,912
2717,1,1,43,1547,1504
2718,0,0,21,0,-21
2719,1,0,60,0,-60
2720,1,0,16,0,-16
2721,1,1,342,1327,985
2722,1,0,24,0,-24
2723,0,0,11,0,-11
2724,0,0,38,0,-38
2725,1,1,1099,1506,407
2726,1,0,51,0,-51
2727,1,0,54,0,-54
2728,0,0,14,0,-14
2729,1,0,24,0,-24
2730,0,0,13,0,-13
2731,0,0,5,0,-5
2732,0,0,27,0,-27
2733,1,1,277,1459,1182
2734,0,0,71,0,-71
2735,0,0,44,0,-44
2736,1,1,449,1504,1055
2737,0,0,38,0,-38
2738,1,1,703,1435,732
2739,1,0,91,0,-91
2740,0,0,44,0,-44
2741,1,0,187,0,-187
2742,1,1,222,1434,1212
2743,1,1,503,1555,1052
2744,0,0,3,0,-3
2745,1,0,6,0,-6
2746,1,1,713,1281,568
2747,1,1,338,1326,988
2748,0,0,44,0,-44
2749,0,0,109,0,-109
2750,0,0,64,0,-64
2751,1,1,921,1422,501
2752,0,0,1,0,-1
2753,1,0,11,0,-11
2754,1,1,714,1243,529
2755,0,0,54,0,-54
2756,0,0,36,0,-36
2757,0,0,197,0,-197
2758,1,1,175,1460,1285
2759,1,0,56,0,-56
2760,0,0,12,0,-12
2761,1,0,33,0,-33
2762,0,0,1,0,-1
2763,0,0,42,0,-42
2764,1,0,25,0,-25
2765,0,0,51,0,-51
2766,1,1,282,1563,1281
2767,1,1,1015,1290,275
2768,1,0,92,0,-92
2769,1,1,424,1267,843
2770,1,0,103,0,-103
2771,0,0,34,0,-34
2772,0,0,33,0,-33
2773,1,0,2,0,-2
2774,0,0,0,0,0
2775,1,1,575,1472,897
2776,1,0,157,0,-157
2777,0,0,12,0,-12
2778,0,0,10,0,-10
2779,0,0,30,0,-30
2780,0,0,48,0,-48
2781,0,0,13,0,-13
2782,1,0,18,0,-18
2783,0,0,53,0,-53
2784,0,0,50,0,-50
2785,1,1,698,1681,983
2786,0,0,10,0,-10
2787,1,1,397,1403,1006
2788,0,0,27,0,-27
2789,1,1,486,1639,1153
2790,1,0,24,0,-24
2791,0,0,106,0,-106
2792,1,0,12,0,-12
2793,1,0,131,0,-131
2794,0,0,9,0,-9
2795,1,1,35,1232,1197
2796,0,0,6,0,-6
2797,0,0,11,0,-11
2798,0,0,94,0,-94
2799,1,1,1621,1306,-315
2800,0,0,15,0,-15
2801,1,0,22,0,-22
2802,1,0,31,0,-31
2803,1,0,34,0,-34
2804,1,0,41,0,-41
2805,0,0,78,0,-78
2806,1,0,78,0,-78
2807,0,0,31,0,-31
2808,1,0,2,0,-2
2809,1,1,377,1409,1032
2810,1,0,74,0,-74
2811,1,1,314,1314,1000
2812,1,1,1090,1255,165
2813,1,1,364,1314,950
2814,1,1,387,3849,3462
2815,1,1,86,1251,1165
2816,1,1,723,1564,841
2817,1,1,1969,1322,-647
2818,0,0,61,0,-61
2819,1,0,23,0,-23
2820,1,0,28,0,-28
2821,1,1,83,1335,1252
2822,0,0,15,0,-15
2823,1,1,1758,1392,-366
2824,1,0,12,0,-12
2825,0,0,36,0,-36
2826,1,0,342,0,-342
2827,0,0,17,0,-17
2828,0,0,134,0,-134
2829,1,0,6,0,-6
2830,0,0,54,0,-54
2831,1,1,639,1600,961
2832,1,1,190,2390,2200
2833,0,0,14,0,-14
2834,1,0,208,0,-208
2835,0,0,39,0,-39
2836,1,1,53,2116,2063
2837,1,0,49,0,-49
2838,0,0,40,0,-40
2839,1,1,735,1301,566
2840,1,1,602,1702,1100
2841,0,0,64,0,-64
2842,1,0,89,0,-89
2843,0,0,30,0,-30
2844,1,1,745,1709,964
2845,1,0,20,0,-20
2846,0,0,7,0,-7
2847,1,0,77,0,-77
2848,1,1,239,1791,1552
2849,0,0,140,0,-140
2850,1,1,168,1338,1170
2851,0,0,17,0,-17
2852,0,0,19,0,-19
2853,0,0,40,0,-40
2854,1,1,1792,2740,948
2855,1,1,210,1293,1083
2856,0,0,24,0,-24
2857,1,1,361,1584,1223
2858,1,0,13,0,-13
2859,0,0,33,0,-33
2860,1,0,69,0,-69
2861,0,0,0,0,0
2862,1,0,75,0,-75
2863,1,0,65,0,-65
2864,0,0,17,0,-17
2865,0,0,53,0,-53
2866,1,1,483,1708,1225
2867,1,1,149,1219,1070
2868,0,0,25,0,-25
2869,1,0,0,0,0
2870,1,0,73,0,-73
2871,0,0,0,0,0
2872,0,0,78,0,-78
2873,1,0,6,0,-6
2874,0,0,89,0,-89
2875,0,0,0,0,0
2876,1,1,204,3008,2804
2877,1,0,4,0,-4
2878,0,0,7,0,-7
2879,1,1,171,1231,1060
2880,1,1,219,1410,1191
2881,1,0,180,0,-180
2882,0,0,26,0,-26
2883,0,0,31,0,-31
2884,1,0,10,0,-10
2885,0,0,32,0,-32
2886,0,0,12,0,-12
2887,1,1,935,1455,520
2888,1,0,4,0,-4
2889,0,0,116,0,-116
2890,1,1,1489,1741,252
2891,1,1,708,1220,512
2892,0,0,201,0,-201
2893,1,1,799,1219,420
2894,1,0,123,0,-123
2895,0,0,97,0,-97
2896,1,1,292,7086,6794
2897,1,1,361,1561,1200
2898,1,1,761,1667,906
2899,0,0,19,0,-19
2900,0,0,14,0,-14
2901,1,0,86,0,-86
2902,0,0,20,0,-20
2903,0,0,0,0,0
2904,1,1,43,2306,2263
2905,1,1,371,1451,1080
2906,1,1,243,1561,1318
2907,0,0,0,0,0
2908,0,0,16,0,-16
2909,1,0,103,0,-103
2910,1,0,21,0,-21
2911,0,0,14,0,-14
2912,0,0,1,0,-1
2913,1,0,22,0,-22
2914,0,0,22,0,-22
2915,1,0,54,0,-54
2916,1,1,612,1242,630
2917,1,1,511,1734,1223
2918,1,1,693,1648,955
2919,1,0,6,0,-6
2920,1,0,53,0,-53
2921,0,0,52,0,-52
2922,1,1,845,1867,1022
2923,1,0,17,0,-17
2924,0,0,11,0,-11
2925,1,0,9,0,-9
2926,0,0,2,0,-2
2927,0,0,56,0,-56
2928,0,0,15,0,-15
2929,1,1,902,1242,340
2930,0,0,1,0,-1
2931,1,1,781,1210,429
2932,1,1,328,1463,1135
2933,0,0,54,0,-54
2934,1,0,33,0,-33
2935,1,1,727,1305,578
2936,1,0,96,0,-96
2937,0,0,39,0,-39
2938,1,1,93,2016,1923
2939,1,1,1968,1659,-309
2940,1,1,598,1479,881
2941,1,1,662,1358,696
2942,1,0,16,0,-16
2943,1,1,674,1244,570
2944,1,0,74,0,-74
2945,0,0,24,0,-24
2946,0,0,104,0,-104
2947,0,0,35,0,-35
2948,1,1,2924,1412,-1512
2949,1,0,3,0,-3
2950,0,0,42,0,-42
2951,0,0,67,0,-67
2952,1,1,1457,1232,-225
2953,1,0,12,0,-12
2954,0,0,15,0,-15
2955,1,1,385,1319,934
2956,1,1,225,1610,1385
2957,1,1,465,1203,738
2958,0,0,95,0,-95
2959,1,0,1,0,-1
2960,0,0,149,0,-149
2961,1,1,887,1468,581
2962,0,0,239,0,-239
2963,0,0,79,0,-79
2964,1,1,898,1226,328
2965,0,0,210,0,-210
2966,1,0,10,0,-10
2967,1,1,1016,1403,387
2968,1,1,400,1530,1130
2969,0,0,22,0,-22
2970,1,1,1054,1730,676
2971,1,0,21,0,-21
2972,0,0,4,0,-4
2973,0,0,48,0,-48
2974,0,0,121,0,-121
2975,0,0,16,0,-16
2976,1,1,178,1265,1087
2977,1,1,168,1488,1320
2978,1,1,658,1719,1061
2979,1,1,66,1214,1148
2980,1,0,75,0,-75
2981,1,0,37,0,-37
2982,0,0,87,0,-87
2983,0,0,5,0,-5
2984,1,1,1518,1576,58
2985,1,0,187,0,-187
2986,1,1,344,2492,2148
2987,0,0,33,0,-33
2988,0,0,25,0,-25
2989,0,0,11,0,-11
2990,0,0,19,0,-19
2991,0,0,58,0,-58
2992,1,0,19,0,-19
2993,0,0,12,0,-12
2994,0,0,15,0,-15
2995,1,1,1458,1457,-1
2996,0,0,10,0,-10
2997,1,1,110,1381,1271
2998,1,0,73,0,-73
2999,0,0,27,0,-27
3000,0,0,19,0,-19
3001,1,0,3,0,-3
3002,0,0,9,0,-9
3003,0,0,10,0,-10
3004,0,0,117,0,-117
3005,0,0,68,0,-68
3006,1,1,204,1296,1092
3007,0,0,30,0,-30
3008,1,1,367,1208,841
3009,1,0,63,0,-63
3010,0,0,8,0,-8
3011,1,1,339,1303,964
3012,1,0,1,0,-1
3013,1,0,47,0,-47
3014,1,1,327,1618,1291
3015,1,0,13,0,-13
3016,0,0,83,0,-83
3017,1,1,11,1477,1466
3018,1,0,54,0,-54
3019,1,0,10,0,-10
3020,1,1,3531,1364,-2167
3021,0,0,77,0,-77
3022,0,0,15,0,-15
3023,1,1,454,1518,1064
3024,0,0,35,0,-35
3025,1,0,9,0,-9
3026,1,0,24,0,-24
3027,1,1,1339,3191,1852
3028,0,0,72,0,-72
3029,0,0,4,0,-4
3030,0,0,119,0,-119
3031,1,0,21,0,-21
3032,0,0,27,0,-27
3033,1,1,806,1210,404
3034,1,0,114,0,-114
3035,1,1,1022,1643,621
3036,0,0,85,0,-85
3037,1,1,476,2077,1601
3038,0,0,22,0,-22
3039,0,0,139,0,-139
3040,1,0,58,0,-58
3041,0,0,20,0,-20
3042,1,0,10,0,-10
3043,1,1,1714,1223,-491
3044,1,0,149,0,-149
3045,0,0,31,0,-31
3046,0,0,94,0,-94
3047,1,0,7,0,-7
3048,1,0,77,0,-77
3049,0,0,14,0,-14
3050,1,1,542,1361,819
3051,1,1,446,2074,1628
3052,1,0,39,0,-39
3053,0,0,57,0,-57
3054,0,0,17,0,-17
3055,0,0,17,0,-17
3056,0,0,27,0,-27
3057,0,0,121,0,-121
3058,0,0,7,0,-7
3059,1,0,36,0,-36
3060,1,1,532,1600,1068
3061,1,0,23,0,-23
3062,0,0,37,0,-37
3063,1,1,1177,1341,164
3064,1,1,183,1217,1034
3065,0,0,7,0,-7
3066,1,1,1795,1293,-502
3067,1,0,21,0,-21
3068,1,0,0,0,0
3069,0,0,16,0,-16
3070,1,1,621,1230,609
3071,1,1,634,1318,684
3072,1,1,936,1431,495
3073,0,0,82,0,-82
3074,0,0,38,0,-38
3075,1,1,521,1974,1453
3076,1,0,13,0,-13
3077,1,0,0,0,0
3078,0,0,27,0,-27
3079,0,0,66,0,-66
3080,1,0,72,0,-72
3081,0,0,35,0,-35
3082,1,1,1332,1283,-49
3083,1,1,273,1315,1042
3084,0,0,65,0,-65
3085,0,0,13,0,-13
3086,1,1,982,1269,287
3087,1,0,2,0,-2
3088,1,1,3451,1595,-1856
3089,0,0,160,0,-160
3090,1,0,79,0,-79
3091,0,0,94,0,-94
3092,1,1,341,1953,1612
3093,0,0,5,0,-5
3094,1,1,742,1409,667
3095,1,0,0,0,0
3096,1,0,86,0,-86
3097,0,0,32,0,-32
3098,1,0,180,0,-180
3099,0,0,51,0,-51
3100,0,0,6,0,-6
3101,0,0,91,0,-91
3102,0,0,5,0,-5
3103,1,0,4,0,-4
3104,1,1,209,2171,1962
3105,0,0,10,0,-10
3106,1,0,14,0,-14
3107,1,1,332,1295,963
3108,1,0,41,0,-41
3109,0,0,91,0,-91
3110,1,0,129,0,-129
3111,1,0,5,0,-5
3112,0,0,27,0,-27
3113,0,0,0,0,0
3114,0,0,58,0,-58
3115,1,0,13,0,-13
3116,0,0,3,0,-3
3117,1,1,672,2207,1535
3118,0,0,7,0,-7
3119,1,0,60,0,-60
3120,1,1,1566,1491,-75
3121,0,0,24,0,-24
3122,1,1,124,1335,1211
3123,1,0,71,0,-71
3124,0,0,3,0,-3
3125,1,0,120,0,-120
3126,0,0,23,0,-23
3127,1,1,734,1757,1023
3128,1,1,476,1431,955
3129,0,0,6,0,-6
3130,1,0,139,0,-139
3131,0,0,1,0,-1
3132,1,1,136,1208,1072
3133,0,0,84,0,-84
3134,0,0,23,0,-23
3135,0,0,36,0,-36
3136,0,0,14,0,-14
3137,1,1,659,1242,583
3138,0,0,31,0,-31
3139,1,1,409,1848,1439
3140,1,0,10,0,-10
3141,0,0,117,0,-117
3142,0,0,239,0,-239
3143,1,1,752,1472,720
3144,0,0,248,0,-248
3145,1,1,1545,1904,359
3146,0,0,118,0,-118
3147,0,0,30,0,-30
3148,0,0,30,0,-30
3149,1,1,1010,1275,265
3150,0,0,40,0,-40
3151,1,1,332,2391,2059
3152,0,0,26,0,-26
3153,1,1,106,1302,1196
3154,0,0,48,0,-48
3155,1,0,31,0,-31
3156,1,0,20,0,-20
3157,1,1,358,1219,861
3158,0,0,25,0,-25
3159,0,0,11,0,-11
3160,1,1,379,1445,1066
3161,1,0,21,0,-21
3162,1,1,142,1725,1583
3163,0,0,78,0,-78
3164,0,0,64,0,-64
3165,1,1,119,1507,1388
3166,1,0,21,0,-21
3167,0,0,57,0,-57
3168,0,0,21,0,-21
3169,1,1,483,1891,1408
3170,1,1,300,1250,950
3171,1,1,566,1205,639
3172,0,0,11,0,-11
3173,1,0,71,0,-71
3174,1,0,28,0,-28
3175,1,0,178,0,-178
3176,1,1,1542,1553,11
3177,1,0,76,0,-76
3178,1,1,599,1917,1318
3179,0,0,65,0,-65
3180,1,0,67,0,-67
3181,1,1,356,1355,999
3182,1,0,37,0,-37
3183,1,1,1294,1220,-74
3184,0,0,24,0,-24
3185,1,0,0,0,0
3186,0,0,41,0,-41
3187,0,0,26,0,-26
3188,0,0,31,0,-31
3189,1,0,140,0,-140
3190,1,1,360,1370,1010
3191,1,0,5,0,-5
3192,1,1,1086,1638,552
3193,1,1,808,2187,1379
3194,0,0,105,0,-105
3195,1,1,335,1335,1000
3196,0,0,1,0,-1
3197,0,0,57,0,-57
3198,1,1,15,1211,1196
3199,1,0,18,0,-18
3200,0,0,34,0,-34
3201,0,0,16,0,-16
3202,1,0,5,0,-5
3203,1,0,40,0,-40
3204,1,1,528,1251,723
3205,0,0,36,0,-36
3206,0,0,3,0,-3
3207,0,0,50,0,-50
3208,1,0,46,0,-46
3209,0,0,78,0,-78
3210,0,0,178,0,-178
3211,1,1,613,2104,1491
3212,0,0,35,0,-35
3213,0,0,8,0,-8
3214,1,1,150,1614,1464
3215,1,0,54,0,-54
3216,0,0,5,0,-5
3217,0,0,0,0,0
3218,0,0,8,0,-8
3219,1,0,58,0,-58
3220,0,0,30,0,-30
3221,0,0,55,0,-55
3222,1,1,1036,1205,169
3223,1,0,5,0,-5
3224,0,0,123,0,-123
3225,1,1,272,1358,1086
3226,0,0,50,0,-50
3227,1,1,563,1270,707
3228,1,1,503,1369,866
3229,0,0,114,0,-114
3230,1,1,639,1210,571
3231,1,1,251,1272,1021
3232,1,0,122,0,-122
3233,1,1,679,1390,711
3234,1,1,90,1741,1651
3235,0,0,34,0,-34
3236,0,0,38,0,-38
3237,1,0,129,0,-129
3238,1,0,38,0,-38
3239,1,0,37,0,-37
3240,1,1,80,1346,1266
3241,0,0,40,0,-40
3242,0,0,97,0,-97
3243,0,0,38,0,-38
3244,0,0,21,0,-21
3245,1,0,16,0,-16
3246,1,1,190,1552,1362
3247,1,0,69,0,-69
3248,0,0,40,0,-40
3249,0,0,84,0,-84
3250,1,0,38,0,-38
3251,1,1,123,1660,1537
3252,1,0,116,0,-116
3253,0,0,31,0,-31
3254,0,0,158,0,-158
3255,0,0,7,0,-7
3256,1,1,289,1228,939
3257,1,0,46,0,-46
3258,0,0,248,0,-248
3259,1,0,2,0,-2
3260,0,0,10,0,-10
3261,0,0,68,0,-68
3262,0,0,42,0,-42
3263,1,0,35,0,-35
3264,0,0,20,0,-20
3265,1,0,20,0,-20
3266,0,0,40,0,-40
3267,1,1,147,1351,1204
3268,1,0,38,0,-38
3269,1,1,273,1353,1080
3270,1,0,88,0,-88
3271,0,0,70,0,-70
3272,0,0,107,0,-107
3273,0,0,61,0,-61
3274,1,0,28,0,-28
3275,0,0,102,0,-102
3276,0,0,38,0,-38
3277,0,0,91,0,-91
3278,0,0,8,0,-8
3279,1,1,406,2139,1733
3280,0,0,20,0,-20
3281,0,0,13,0,-13
3282,1,0,36,0,-36
3283,0,0,128,0,-128
3284,0,0,9,0,-9
3285,1,1,145,1210,1065
3286,1,0,219,0,-219
3287,1,0,59,0,-59
3288,1,0,38,0,-38
3289,1,1,1343,1602,259
3290,1,0,25,0,-25
3291,1,0,6,0,-6
3292,0,0,130,0,-130
3293,1,1,170,1419,1249
3294,1,0,45,0,-45
3295,1,0,56,0,-56
3296,1,0,71,0,-71
3297,1,1,995,1229,234
3298,1,1,88,1261,1173
3299,1,1,494,1366,872
3300,0,0,38,0,-38
3301,1,1,528,1424,896
3302,1,1,223,1339,1116
3303,0,0,258,0,-258
3304,0,0,0,0,0
3305,1,0,72,0,-72
3306,1,1,651,1239,588
3307,0,0,0,0,0
3308,1,0,122,0,-122
3309,1,1,205,1586,1381
3310,0,0,9,0,-9
3311,0,0,122,0,-122
3312,0,0,10,0,-10
3313,1,0,16,0,-16
3314,1,0,57,0,-57
3315,1,0,49,0,-49
3316,0,0,53,0,-53
3317,1,1,803,1226,423
3318,1,0,55,0,-55
3319,1,0,2,0,-2
3320,1,1,722,1486,764
3321,1,1,479,1425,946
3322,0,0,59,0,-59
3323,0,0,33,0,-33
3324,0,0,49,0,-49
3325,0,0,83,0,-83
3326,1,0,9,0,-9
3327,1,0,82,0,-82
3328,1,1,595,1337,742
3329,1,1,37,1623,1586
3330,0,0,11,0,-11
3331,1,1,672,2542,1870
3332,0,0,14,0,-14
3333,1,0,133,0,-133
3334,1,0,129,0,-129
3335,1,0,119,0,-119
3336,1,1,209,1433,1224
3337,0,0,14,0,-14
3338,1,0,6,0,-6
3339,1,0,51,0,-51
3340,1,1,386,1757,1371
3341,1,0,146,0,-146
3342,1,0,46,0,-46
3343,1,0,4,0,-4
3344,1,1,99,3260,3161
3345,0,0,1,0,-1
3346,0,0,192,0,-192
3347,0,0,18,0,-18
3348,1,0,17,0,-17
3349,1,1,1730,1263,-467
3350,1,1,676,1340,664
3351,1,0,131,0,-131
3352,1,0,26,0,-26
3353,0,0,5,0,-5
3354,1,0,143,0,-143
3355,0,0,34,0,-34
3356,0,0,78,0,-78
3357,1,1,220,1246,1026
3358,0,0,33,0,-33
3359,1,1,689,1240,551
3360,1,0,10,0,-10
3361,0,0,86,0,-86
3362,1,0,8,0,-8
3363,0,0,52,0,-52
3364,0,0,5,0,-5
3365,1,0,95,0,-95
3366,1,0,41,0,-41
3367,1,1,1137,2461,1324
3368,1,0,50,0,-50
3369,1,0,95,0,-95
3370,1,1,850,1454,604
3371,0,0,15,0,-15
3372,1,1,512,1326,814
3373,0,0,7,0,-7
3374,1,0,30,0,-30
3375,0,0,189,0,-189
3376,1,0,37,0,-37
3377,1,0,92,0,-92
3378,0,0,63,0,-63
3379,1,0,172,0,-172
3380,1,1,336,1344,1008
3381,1,0,80,0,-80
3382,1,0,78,0,-78
3383,1,1,2248,1221,-1027
3384,1,1,768,1395,627
3385,1,1,63,1304,1241
3386,0,0,9,0,-9
3387,1,1,1214,1352,138
3388,1,1,367,1532,1165
3389,1,0,6,0,-6
3390,1,0,19,0,-19
3391,1,0,235,0,-235
3392,1,0,23,0,-23
3393,0,0,11,0,-11
3394,1,1,419,1388,969
3395,1,0,63,0,-63
3396,0,0,21,0,-21
3397,0,0,3,0,-3
3398,0,0,0,0,0
3399,0,0,56,0,-56
3400,1,1,108,1457,1349
3401,1,1,471,1847,1376
3402,0,0,134,0,-134
3403,1,0,41,0,-41
3404,1,1,1153,1201,48
3405,1,1,70,1297,1227
3406,0,0,150,0,-150
3407,0,0,80,0,-80
3408,1,0,100,0,-100
3409,1,0,18,0,-18
3410,0,0,66,0,-66
3411,1,1,226,1310,1084
3412,1,1,74,1523,1449
3413,0,0,122,0,-122
3414,1,0,7,0,-7
3415,0,0,3,0,-3
3416,0,0,30,0,-30
3417,1,0,38,0,-38
3418,1,0,51,0,-51
3419,0,0,58,0,-58
3420,0,0,74,0,-74
3421,0,0,50,0,-50
3422,0,0,51,0,-51
3423,1,1,725,1361,636
3424,0,0,4,0,-4
3425,1,0,39,0,-39
3426,1,0,67,0,-67
3427,1,1,2862,1306,-1556
3428,0,0,4,0,-4
3429,1,1,58,1380,1322
3430,0,0,38,0,-38
3431,1,1,801,1574,773
3432,1,1,192,1457,1265
3433,1,1,131,1308,1177
3434,0,0,2,0,-2
3435,1,1,706,1215,509
3436,0,0,12,0,-12
3437,0,0,47,0,-47
3438,1,0,122,0,-122
3439,1,0,17,0,-17
3440,1,1,118,1333,1215
3441,1,0,11,0,-11
3442,0,0,133,0,-133
3443,1,0,5,0,-5
3444,0,0,4,0,-4
3445,1,1,116,1263,1147
3446,1,1,250,1415,1165
3447,1,0,10,0,-10
3448,0,0,2,0,-2
3449,1,0,35,0,-35
3450,0,0,52,0,-52
3451,1,1,111,1362,1251
3452,1,0,72,0,-72
3453,0,0,72,0,-72
3454,1,1,190,1201,1011
3455,1,1,589,1408,819
3456,1,0,63,0,-63
3457,0,0,140,0,-140
3458,1,1,1659,1534,-125
3459,1,0,50,0,-50
3460,1,1,844,1836,992
3461,0,0,44,0,-44
3462,1,1,852,1461,609
3463,0,0,92,0,-92
3464,0,0,1,0,-1
3465,1,1,96,1413,1317
3466,0,0,3,0,-3
3467,0,0,12,0,-12
3468,0,0,37,0,-37
3469,1,0,10,0,-10
3470,1,1,75,1680,1605
3471,1,1,788,2020,1232
3472,1,0,52,0,-52
3473,0,0,4,0,-4
3474,1,0,33,0,-33
3475,1,0,53,0,-53
3476,0,0,64,0,-64
3477,1,0,42,0,-42
3478,1,0,109,0,-109
3479,1,0,126,0,-126
3480,1,1,821,1214,393
3481,1,0,77,0,-77
3482,0,0,65,0,-65
3483,1,1,271,1400,1129
3484,1,0,46,0,-46
3485,0,0,6,0,-6
3486,0,0,151,0,-151
3487,1,1,133,1499,1366
3488,1,0,26,0,-26
3489,1,1,331,1229,898
3490,1,1,958,1247,289
3491,0,0,35,0,-35
3492,1,0,1,0,-1
3493,1,0,23,0,-23
3494,1,0,75,0,-75
3495,0,0,26,0,-26
3496,1,0,12,0,-12
3497,1,1,110,1244,1134
3498,1,0,6,0,-6
3499,1,0,49,0,-49
3500,1,1,435,1644,1209
3501,1,1,170,1233,1063
3502,1,0,4,0,-4
3503,1,0,15,0,-15
3504,1,1,1182,1390,208
3505,1,1,27,1257,1230
3506,1,1,1303,1217,-86
3507,1,0,47,0,-47
3508,0,0,11,0,-11
3509,0,0,53,0,-53
3510,1,0,22,0,-22
3511,0,0,158,0,-158
3512,0,0,168,0,-168
3513,1,1,813,1230,417
3514,0,0,32,0,-32
3515,1,0,24,0,-24
3516,0,0,10,0,-10
3517,0,0,16,0,-16
3518,0,0,13,0,-13
3519,1,1,482,1784,1302
3520,0,0,24,0,-24
3521,1,0,64,0,-64
3522,1,1,40,1320,1280
3523,0,0,25,0,-25
3524,1,0,32,0,-32
3525,0,0,70,0,-70
3526,0,0,15,0,-15
3527,1,0,0,0,0
3528,0,0,19,0,-19
3529,0,0,15,0,-15
3530,1,0,34,0,-34
3531,1,0,5,0,-5
3532,1,1,73,2287,2214
3533,0,0,245,0,-245
3534,0,0,20,0,-20
3535,1,0,3,0,-3
3536,0,0,111,0,-111
3537,1,1,1447,1440,-7
3538,0,0,21,0,-21
3539,0,0,29,0,-29
3540,1,1,144,1344,1200
3541,1,0,9,0,-9
3542,0,0,167,0,-167
3543,0,0,35,0,-35
3544,1,1,1409,1398,-11
3545,1,1,682,1244,562
3546,1,1,1048,1326,278
3547,0,0,1,0,-1
3548,0,0,79,0,-79
3549,0,0,10,0,-10
3550,1,1,532,2162,1630
3551,0,0,166,0,-166
3552,1,0,166,0,-166
3553,0,0,27,0,-27
3554,0,0,37,0,-37
3555,1,1,353,1511,1158
3556,1,0,1,0,-1
3557,0,0,76,0,-76
3558,1,1,216,2936,2720
3559,1,1,2399,1503,-896
3560,1,0,99,0,-99
3561,1,0,86,0,-86
3562,0,0,13,0,-13
3563,0,0,0,0,0
3564,1,1,295,1397,1102
3565,0,0,124,0,-124
3566,1,1,206,1276,1070
3567,0,0,39,0,-39
3568,1,0,0,0,0
3569,0,0,29,0,-29
3570,0,0,70,0,-70
3571,1,1,423,1206,783
3572,1,1,712,1270,558
3573,1,0,126,0,-126
3574,1,0,51,0,-51
3575,1,1,220,1748,1528
3576,1,0,108,0,-108
3577,1,1,497,1723,1226
3578,1,0,12,0,-12
3579,1,0,102,0,-102
3580,0,0,111,0,-111
3581,1,1,162,2004,1842
3582,1,0,44,0,-44
3583,1,1,322,1551,1229
3584,1,0,87,0,-87
3585,0,0,23,0,-23
3586,0,0,2,0,-2
3587,1,1,932,2770,1838
3588,1,0,31,0,-31
3589,1,0,13,0,-13
3590,1,1,959,2216,1257
3591,1,0,60,0,-60
3592,1,1,825,1547,722
3593,1,1,236,1277,1041
3594,0,0,85,0,-85
3595,0,0,2,0,-2
3596,1,0,74,0,-74
3597,0,0,36,0,-36
3598,1,0,8,0,-8
3599,0,0,1,0,-1
3600,1,0,111,0,-111
3601,1,0,0,0,0
3602,1,1,598,1611,1013
3603,1,0,72,0,-72
3604,1,0,32,0,-32
3605,0,0,34,0,-34
3606,0,0,66,0,-66
3607,0,0,142,0,-142
3608,1,1,189,1843,1654
3609,0,0,74,0,-74
3610,0,0,9,0,-9
3611,1,1,432,1329,897
3612,1,1,279,1236,957
3613,0,0,13,0,-13
3614,1,1,120,1265,1145
3615,1,0,90,0,-90
3616,1,1,264,1247,983
3617,1,1,777,1373,596
3618,1,0,2,0,-2
3619,1,0,24,0,-24
3620,1,1,508,1900,1392
3621,1,1,1620,1259,-361
3622,0,0,27,0,-27
3623,1,0,22,0,-22
3624,0,0,81,0,-81
3625,1,1,259,2337,2078
3626,1,0,64,0,-64
3627,1,1,93,2637,2544
3628,1,0,33,0,-33
3629,1,1,274,1253,979
3630,1,1,857,1230,373
3631,0,0,40,0,-40
3632,0,0,68,0,-68
3633,0,0,97,0,-97
3634,0,0,22,0,-22
3635,1,0,15,0,-15
3636,1,1,470,1662,1192
3637,1,0,36,0,-36
3638,1,0,3,0,-3
3639,1,0,43,0,-43
3640,1,1,178,1499,1321
3641,0,0,53,0,-53
3642,1,1,776,1823,1047
3643,0,0,25,0,-25
3644,0,0,0,0,0
3645,1,1,320,1543,1223
3646,0,0,22,0,-22
3647,1,1,2576,1441,-1135
3648,1,1,114,1376,1262
3649,0,0,55,0,-55
3650,0,0,0,0,0
3651,1,0,54,0,-54
3652,1,0,93,0,-93
3653,1,0,15,0,-15
3654,1,0,4,0,-4
3655,0,0,19,0,-19
3656,0,0,96,0,-96
3657,1,1,1099,1219,120
3658,1,1,118,1628,1510
3659,0,0,118,0,-118
3660,0,0,191,0,-191
3661,1,1,731,1407,676
3662,1,0,55,0,-55
3663,0,0,19,0,-19
3664,0,0,4,0,-4
3665,0,0,18,0,-18
3666,0,0,20,0,-20
3667,1,1,392,1270,878
3668,1,1,344,1251,907
3669,1,0,63,0,-63
3670,1,0,50,0,-50
3671,0,0,34,0,-34
3672,0,0,47,0,-47
3673,0,0,100,0,-100
3674,0,0,41,0,-41
3675,1,0,6,0,-6
3676,1,0,15,0,-15
3677,0,0,78,0,-78
3678,0,0,21,0,-21
3679,1,1,315,2172,1857
3680,1,0,67,0,-67
3681,1,0,31,0,-31
3682,1,0,50,0,-50
3683,0,0,14,0,-14
3684,1,0,117,0,-117
3685,0,0,1,0,-1
3686,0,0,50,0,-50
3687,0,0,89,0,-89
3688,1,0,11,0,-11
3689,1,0,16,0,-16
3690,0,0,13,0,-13
3691,1,1,607,1611,1004
3692,0,0,23,0,-23
3693,0,0,15,0,-15
3694,0,0,10,0,-10
3695,1,0,212,0,-212
3696,1,0,14,0,-14
3697,1,0,41,0,-41
3698,0,0,22,0,-22
3699,1,1,1247,1543,296
3700,1,1,215,1300,1085
3701,1,0,53,0,-53
3702,1,0,14,0,-14
3703,1,0,43,0,-43
3704,1,0,13,0,-13
3705,1,0,30,0,-30
3706,0,0,3,0,-3
3707,1,1,444,1671,1227
3708,1,1,543,2056,1513
3709,1,1,369,1877,1508
3710,0,0,53,0,-53
3711,0,0,3,0,-3
3712,1,0,0,0,0
3713,0,0,14,0,-14
3714,1,0,27,0,-27
3715,0,0,19,0,-19
3716,1,0,23,0,-23
3717,1,0,20,0,-20
3718,0,0,118,0,-118
3719,1,0,14,0,-14
3720,1,0,1,0,-1
3721,0,0,6,0,-6
3722,1,0,11,0,-11
3723,1,0,70,0,-70
3724,1,0,15,0,-15
3725,0,0,27,0,-27
3726,1,0,85,0,-85
3727,1,0,56,0,-56
3728,1,0,52,0,-52
3729,0,0,49,0,-49
3730,1,1,54,1343,1289
3731,1,0,76,0,-76
3732,1,1,404,1274,870
3733,1,1,425,1220,795
3734,1,1,457,1280,823
3735,1,0,300,0,-300
3736,0,0,47,0,-47
3737,0,0,46,0,-46
3738,0,0,11,0,-11
3739,1,1,1143,1386,243
3740,0,0,3,0,-3
3741,1,0,85,0,-85
3742,1,1,986,1247,261
3743,1,1,214,1339,1125
3744,1,0,61,0,-61
3745,0,0,4,0,-4
3746,1,0,91,0,-91
3747,1,0,1,0,-1
3748,1,1,292,1516,1224
3749,1,0,16,0,-16
3750,1,0,22,0,-22
3751,1,0,26,0,-26
3752,0,0,8,0,-8
3753,0,0,16,0,-16
3754,1,0,26,0,-26
3755,1,0,22,0,-22
3756,1,0,6,0,-6
3757,1,0,23,0,-23
3758,1,1,1373,2581,1208
3759,1,1,192,1868,1676
3760,1,1,596,1250,654
3761,1,0,94,0,-94
3762,1,0,4,0,-4
3763,1,0,92,0,-92
3764,1,1,149,1442,1293
3765,1,0,38,0,-38
3766,0,0,38,0,-38
3767,0,0,13,0,-13
3768,0,0,24,0,-24
3769,1,0,12,0,-12
3770,1,1,330,1291,961
3771,1,0,37,0,-37
3772,1,1,329,1863,1534
3773,1,0,67,0,-67
3774,1,1,159,1270,1111
3775,1,1,1466,1203,-263
3776,1,0,115,0,-115
3777,0,0,42,0,-42
3778,1,1,115,1268,1153
3779,0,0,112,0,-112
3780,1,1,389,1308,919
3781,1,0,14,0,-14
3782,0,0,16,0,-16
3783,1,0,99,0,-99
3784,0,0,120,0,-120
3785,1,1,1259,1299,40
3786,1,0,0,0,0
3787,1,1,1048,1261,213
3788,1,1,122,1296,1174
3789,1,0,41,0,-41
3790,1,1,660,1359,699
3791,1,0,21,0,-21
3792,1,0,120,0,-120
3793,1,0,21,0,-21
3794,0,0,58,0,-58
3795,1,1,28,1490,1462
3796,0,0,45,0,-45
3797,1,0,0,0,0
3798,1,0,14,0,-14
3799,1,0,0,0,0
3800,1,0,61,0,-61
3801,1,0,18,0,-18
3802,1,0,16,0,-16
3803,0,0,41,0,-41
3804,1,1,285,1262,977
3805,1,1,1094,1298,204
3806,1,1,194,3326,3132
3807,1,0,93,0,-93
3808,0,0,18,0,-18
3809,1,0,16,0,-16
3810,0,0,29,0,-29
3811,0,0,25,0,-25
3812,0,0,2,0,-2
3813,0,0,108,0,-108
3814,1,1,303,1227,924
3815,1,1,1632,1305,-327
3816,1,1,475,1451,976
3817,1,1,169,1423,1254
3818,1,0,0,0,0
3819,1,0,113,0,-113
3820,1,1,99,1307,1208
3821,1,1,355,1643,1288
3822,1,0,53,0,-53
3823,0,0,66,0,-66
3824,0,0,55,0,-55
3825,1,1,674,1385,711
3826,1,0,7,0,-7
3827,1,0,63,0,-63
3828,1,1,223,1200,977
3829,1,1,224,2037,1813
3830,1,1,122,2078,1956
3831,1,0,37,0,-37
3832,0,0,40,0,-40
3833,1,1,731,1301,570
3834,1,1,611,1598,987
3835,1,0,12,0,-12
3836,0,0,33,0,-33
3837,1,1,370,1594,1224
3838,1,0,12,0,-12
3839,1,0,4,0,-4
3840,0,0,16,0,-16
3841,0,0,36,0,-36
3842,0,0,11,0,-11
3843,1,1,987,1362,375
3844,1,0,107,0,-107
3845,0,0,129,0,-129
3846,0,0,11,0,-11
3847,1,0,61,0,-61
3848,0,0,66,0,-66
3849,0,0,40,0,-40
3850,0,0,56,0,-56
3851,0,0,54,0,-54
3852,1,0,80,0,-80
3853,0,0,33,0,-33
3854,1,0,1,0,-1
3855,1,0,89,0,-89
3856,1,0,81,0,-81
3857,1,1,145,1726,1581
3858,1,0,20,0,-20
3859,0,0,93,0,-93
3860,1,1,377,1405,1028
3861,1,1,433,1562,1129
3862,1,0,39,0,-39
3863,1,1,844,3297,2453
3864,0,0,9,0,-9
3865,0,0,59,0,-59
3866,0,0,84,0,-84
3867,1,0,297,0,-297
3868,0,0,95,0,-95
3869,0,0,98,0,-98
3870,1,0,13,0,-13
3871,0,0,26,0,-26
3872,0,0,26,0,-26
3873,1,1,494,1319,825
3874,1,0,55,0,-55
3875,1,0,68,0,-68
3876,1,1,135,2047,1912
3877,1,0,8,0,-8
3878,1,0,45,0,-45
3879,1,0,59,0,-59
3880,0,0,19,0,-19
3881,0,0,40,0,-40
3882,0,0,35,0,-35
3883,1,0,40,0,-40
3884,1,0,11,0,-11
3885,0,0,32,0,-32
3886,0,0,90,0,-90
3887,1,0,108,0,-108
3888,0,0,2,0,-2
3889,0,0,6,0,-6
3890,0,0,50,0,-50
3891,0,0,6,0,-6
3892,1,1,188,2109,1921
3893,1,1,645,1434,789
3894,1,1,454,2119,1665
3895,1,1,131,1324,1193
3896,1,1,992,1430,438
3897,1,1,144,1567,1423
3898,1,1,329,1374,1045
3899,0,0,101,0,-101
3900,1,1,206,1363,1157
3901,1,0,275,0,-275
3902,1,0,63,0,-63
3903,1,0,30,0,-30
3904,1,0,60,0,-60
3905,0,0,206,0,-206
3906,0,0,5,0,-5
3907,1,0,106,0,-106
3908,1,0,67,0,-67
3909,1,0,35,0,-35
3910,0,0,35,0,-35
3911,0,0,75,0,-75
3912,1,0,73,0,-73
3913,1,0,93,0,-93
3914,1,0,24,0,-24
3915,1,0,6,0,-6
3916,1,1,416,2980,2564
3917,1,1,14,1233,1219
3918,0,0,45,0,-45
3919,1,1,213,1559,1346
3920,0,0,0,0,0
3921,0,0,29,0,-29
3922,0,0,1,0,-1
3923,1,1,470,1539,1069
3924,1,0,33,0,-33
3925,0,0,40,0,-40
3926,0,0,35,0,-35
3927,1,0,1,0,-1
3928,1,0,42,0,-42
3929,0,0,49,0,-49
3930,0,0,103,0,-103
3931,1,1,265,1386,1121
3932,0,0,34,0,-34
3933,0,0,65,0,-65
3934,1,0,17,0,-17
3935,1,0,27,0,-27
3936,0,0,32,0,-32
3937,0,0,45,0,-45
3938,0,0,7,0,-7
3939,1,0,40,0,-40
3940,1,1,264,1260,996
3941,1,0,6,0,-6
3942,1,0,89,0,-89
3943,0,0,21,0,-21
3944,0,0,44,0,-44
3945,1,1,300,1417,1117
3946,0,0,119,0,-119
3947,0,0,88,0,-88
3948,1,0,116,0,-116
3949,1,0,6,0,-6
3950,1,0,7,0,-7
3951,1,0,54,0,-54
3952,1,1,419,1595,1176
3953,0,0,72,0,-72
3954,1,1,915,1992,1077
3955,1,0,41,0,-41
3956,0,0,147,0,-147
3957,1,1,779,2119,1340
3958,1,0,0,0,0
3959,1,0,93,0,-93
3960,1,0,65,0,-65
3961,0,0,24,0,-24
3962,1,0,44,0,-44
3963,1,1,32,1466,1434
3964,0,0,47,0,-47
3965,0,0,8,0,-8
3966,1,0,47,0,-47
3967,1,1,582,1218,636
3968,1,1,1206,1213,7
3969,0,0,3,0,-3
3970,1,1,306,2258,1952
3971,1,1,79,1490,1411
3972,1,1,980,1344,364
3973,1,1,309,1664,1355
3974,0,0,15,0,-15
3975,1,0,72,0,-72
3976,0,0,113,0,-113
3977,1,1,2250,2097,-153
3978,1,1,1989,2244,255
3979,0,0,77,0,-77
3980,1,0,97,0,-97
3981,0,0,2,0,-2
3982,1,0,118,0,-118
3983,1,1,312,1201,889
3984,1,0,28,0,-28
3985,1,0,12,0,-12
3986,1,1,632,1233,601
3987,1,0,3,0,-3
3988,1,1,142,1364,1222
3989,1,1,16,1736,1720
3990,0,0,50,0,-50
3991,0,0,11,0,-11
3992,0,0,0,0,0
3993,0,0,75,0,-75
3994,1,1,1657,1230,-427
3995,1,1,108,3077,2969
3996,0,0,245,0,-245
3997,1,0,9,0,-9
3998,0,0,78,0,-78
3999,1,1,493,1509,1016
4000,1,0,55,0,-55
4001,1,1,232,1535,1303
4002,1,1,796,1315,519
4003,1,0,3,0,-3
4004,0,0,4,0,-4
4005,0,0,5,0,-5
4006,1,0,26,0,-26
4007,0,0,30,0,-30
4008,1,0,42,0,-42
4009,0,0,10,0,-10
4010,0,0,45,0,-45
4011,0,0,47,0,-47
4012,1,0,4,0,-4
4013,1,0,12,0,-12
4014,1,1,693,1974,1281
4015,1,0,77,0,-77
4016,1,0,1,0,-1
4017,1,0,52,0,-52
4018,1,0,14,0,-14
4019,1,0,9,0,-9
4020,0,0,84,0,-84
4021,1,0,23,0,-23
4022,1,0,23,0,-23
4023,1,1,819,1991,1172
4024,1,0,31,0,-31
4025,0,0,1,0,-1
4026,1,1,1287,1672,385
4027,1,1,113,1655,1542
4028,0,0,77,0,-77
4029,0,0,32,0,-32
4030,0,0,10,0,-10
4031,1,1,584,1933,1349
4032,1,1,1351,1569,218
4033,0,0,36,0,-36
4034,1,0,27,0,-27
4035,1,0,158,0,-158
4036,0,0,70,0,-70
4037,0,0,251,0,-251
4038,1,1,1178,1474,296
4039,0,0,305,0,-305
4040,0,0,22,0,-22
4041,1,1,1473,1418,-55
4042,1,0,36,0,-36
4043,1,0,16,0,-16
4044,0,0,25,0,-25
4045,0,0,18,0,-18
4046,1,1,245,1356,1111
4047,1,0,10,0,-10
4048,1,1,288,1448,1160
4049,1,1,158,1245,1087
4050,1,1,476,1250,774
4051,1,1,196,1414,1218
4052,1,1,145,1291,1146
4053,1,1,486,1543,1057
4054,1,0,33,0,-33
4055,0,0,17,0,-17
4056,0,0,3,0,-3
4057,0,0,35,0,-35
4058,1,0,71,0,-71
4059,1,1,219,1886,1667
4060,1,0,89,0,-89
4061,1,1,918,1841,923
4062,1,0,50,0,-50
4063,0,0,3,0,-3
4064,0,0,68,0,-68
4065,1,1,278,1512,1234
4066,0,0,86,0,-86
4067,1,1,1998,1300,-698
4068,1,1,350,1260,910
4069,0,0,16,0,-16
4070,1,1,420,1457,1037
4071,1,0,145,0,-145
4072,1,0,69,0,-69
4073,1,1,247,1348,1101
4074,1,1,1583,2058,475
4075,1,1,1159,2946,1787
4076,0,0,115,0,-115
4077,0,0,71,0,-71
4078,1,1,1151,1834,683
4079,1,1,995,1493,498
4080,0,0,3,0,-3
4081,1,1,183,1615,1432
4082,1,0,16,0,-16
4083,0,0,1,0,-1
4084,0,0,43,0,-43
4085,1,1,844,1474,630
4086,0,0,2,0,-2
4087,1,0,64,0,-64
4088,0,0,92,0,-92
4089,1,1,317,2392,2075
4090,1,0,13,0,-13
4091,0,0,131,0,-131
4092,0,0,11,0,-11
4093,1,1,1421,1652,231
4094,1,1,470,1497,1027
4095,1,1,151,1299,1148
4096,1,0,39,0,-39
4097,1,0,62,0,-62
4098,0,0,57,0,-57
4099,0,0,11,0,-11
4100,1,0,6,0,-6
4101,1,0,23,0,-23
4102,0,0,31,0,-31
4103,1,1,1840,1205,-635
4104,1,1,223,2356,2133
4105,1,0,0,0,0
4106,1,0,18,0,-18
4107,1,0,133,0,-133
4108,0,0,0,0,0
4109,1,0,66,0,-66
4110,0,0,66,0,-66
4111,0,0,68,0,-68
4112,0,0,7,0,-7
4113,1,0,42,0,-42
4114,0,0,96,0,-96
4115,1,0,98,0,-98
4116,1,1,1422,1229,-193
4117,1,1,105,2332,2227
4118,0,0,21,0,-21
4119,0,0,20,0,-20
4120,1,0,79,0,-79
4121,0,0,1,0,-1
4122,1,0,58,0,-58
4123,0,0,41,0,-41
4124,1,1,218,2707,2489
4125,0,0,51,0,-51
4126,1,0,3,0,-3
4127,1,0,67,0,-67
4128,1,0,67,0,-67
4129,1,1,735,1222,487
4130,1,1,304,2188,1884
4131,1,0,18,0,-18
4132,0,0,34,0,-34
4133,1,1,1171,1513,342
4134,0,0,94,0,-94
4135,1,1,57,1319,1262
4136,1,0,13,0,-13
4137,1,1,222,1217,995
4138,1,1,284,1604,1320
4139,1,0,3,0,-3
4140,0,0,110,0,-110
4141,1,1,1448,1416,-32
4142,0,0,34,0,-34
4143,1,0,119,0,-119
4144,0,0,77,0,-77
4145,0,0,83,0,-83
4146,1,0,54,0,-54
4147,1,0,12,0,-12
4148,0,0,10,0,-10
4149,0,0,84,0,-84
4150,1,0,39,0,-39
4151,1,0,10,0,-10
4152,0,0,52,0,-52
4153,0,0,8,0,-8
4154,0,0,46,0,-46
4155,0,0,26,0,-26
4156,1,0,59,0,-59
4157,1,0,56,0,-56
4158,1,0,22,0,-22
4159,0,0,7,0,-7
4160,0,0,93,0,-93
4161,1,1,820,2359,1539
4162,1,0,37,0,-37
4163,1,1,431,1360,929
4164,0,0,313,0,-313
4165,1,0,1,0,-1
4166,1,0,62,0,-62
4167,1,0,53,0,-53
4168,0,0,5,0,-5
4169,0,0,151,0,-151
4170,0,0,19,0,-19
4171,1,1,356,1584,1228
4172,1,0,2,0,-2
4173,1,0,118,0,-118
4174,1,1,253,1655,1402
4175,1,0,13,0,-13
4176,1,1,1002,2577,1575
4177,1,1,50,1493,1443
4178,0,0,172,0,-172
4179,1,1,55,3866,3811
4180,1,0,2,0,-2
4181,0,0,133,0,-133
4182,1,1,130,1460,1330
4183,1,1,525,1860,1335
4184,0,0,53,0,-53
4185,1,1,192,1267,1075
4186,1,1,187,1226,1039
4187,1,0,33,0,-33
4188,0,0,22,0,-22
4189,1,1,633,1257,624
4190,0,0,1,0,-1
4191,1,1,521,1841,1320
4192,0,0,16,0,-16
4193,1,0,10,0,-10
4194,1,0,71,0,-71
4195,0,0,156,0,-156
4196,1,0,46,0,-46
4197,1,0,95,0,-95
4198,1,1,280,1343,1063
4199,0,0,33,0,-33
4200,0,0,37,0,-37
4201,1,1,102,1692,1590
4202,0,0,20,0,-20
4203,1,1,87,1524,1437
4204,1,0,5,0,-5
4205,0,0,101,0,-101
4206,0,0,51,0,-51
4207,1,1,736,1234,498
4208,1,0,117,0,-117
4209,1,0,88,0,-88
4210,1,1,95,1372,1277
4211,0,0,11,0,-11
4212,1,0,8,0,-8
4213,1,1,178,1287,1109
4214,1,0,19,0,-19
4215,1,0,35,0,-35
4216,1,1,76,1203,1127
4217,1,0,169,0,-169
4218,1,1,393,1279,886
4219,0,0,151,0,-151
4220,0,0,6,0,-6
4221,0,0,70,0,-70
4222,0,0,90,0,-90
4223,0,0,88,0,-88
4224,1,1,47,1564,1517
4225,1,1,465,2230,1765
4226,0,0,63,0,-63
4227,0,0,19,0,-19
4228,0,0,0,0,0
4229,1,0,81,0,-81
4230,0,0,31,0,-31
4231,1,1,227,1329,1102
4232,1,0,42,0,-42
4233,1,0,86,0,-86
4234,1,1,358,1670,1312
4235,0,0,43,0,-43
4236,0,0,56,0,-56
4237,1,0,246,0,-246
4238,1,1,351,1631,1280
4239,1,0,42,0,-42
4240,1,0,41,0,-41
4241,1,1,942,1562,620
4242,1,1,629,1695,1066
4243,1,0,113,0,-113
4244,1,0,13,0,-13
4245,1,1,1175,3289,2114
4246,1,0,130,0,-130
4247,1,1,224,1367,1143
4248,1,0,16,0,-16
4249,1,0,15,0,-15
4250,0,0,137,0,-137
4251,1,1,590,1374,784
4252,1,0,15,0,-15
4253,0,0,9,0,-9
4254,0,0,33,0,-33
4255,1,1,347,1381,1034
4256,1,0,39,0,-39
4257,1,1,152,1541,1389
4258,0,0,13,0,-13
4259,0,0,25,0,-25
4260,1,0,32,0,-32
4261,1,1,241,1256,1015
4262,0,0,81,0,-81
4263,1,0,148,0,-148
4264,1,0,34,0,-34
4265,1,0,51,0,-51
4266,0,0,144,0,-144
4267,1,0,11,0,-11
4268,1,1,292,1251,959
4269,1,0,88,0,-88
4270,0,0,25,0,-25
4271,1,0,19,0,-19
4272,1,1,2248,1284,-964
4273,0,0,69,0,-69
4274,1,1,246,1418,1172
4275,0,0,47,0,-47
4276,0,0,2,0,-2
4277,1,0,48,0,-48
4278,1,0,24,0,-24
4279,0,0,14,0,-14
4280,0,0,25,0,-25
4281,0,0,81,0,-81
4282,1,0,38,0,-38
4283,0,0,15,0,-15
4284,1,1,298,2713,2415
4285,1,1,185,1258,1073
4286,1,1,470,2476,2006
4287,0,0,43,0,-43
4288,1,0,31,0,-31
4289,0,0,4,0,-4
4290,0,0,27,0,-27
4291,1,1,142,1218,1076
4292,0,0,13,0,-13
4293,1,0,36,0,-36
4294,1,1,798,1226,428
4295,0,0,5,0,-5
4296,0,0,54,0,-54
4297,0,0,22,0,-22
4298,1,0,17,0,-17
4299,1,0,10,0,-10
4300,1,0,29,0,-29
4301,0,0,0,0,0
4302,1,1,729,1964,1235
4303,1,0,30,0,-30
4304,1,0,17,0,-17
4305,0,0,68,0,-68
4306,0,0,47,0,-47
4307,1,0,90,0,-90
4308,0,0,31,0,-31
4309,0,0,32,0,-32
4310,1,1,497,2070,1573
4311,0,0,9,0,-9
4312,0,0,16,0,-16
4313,0,0,44,0,-44
4314,1,1,1779,1387,-392
4315,0,0,20,0,-20
4316,1,1,697,1768,1071
4317,0,0,76,0,-76
4318,1,0,1,0,-1
4319,0,0,9,0,-9
4320,0,0,5,0,-5
4321,0,0,10,0,-10
4322,1,1,213,2767,2554
4323,1,1,58,1482,1424
4324,1,0,106,0,-106
4325,1,0,73,0,-73
4326,0,0,27,0,-27
4327,1,1,311,1368,1057
4328,1,0,0,0,0
4329,1,1,488,1230,742
4330,0,0,33,0,-33
4331,0,0,145,0,-145
4332,0,0,189,0,-189
4333,1,0,16,0,-16
4334,0,0,59,0,-59
4335,1,1,207,1437,1230
4336,0,0,1,0,-1
4337,1,1,149,1448,1299
4338,0,0,89,0,-89
4339,0,0,28,0,-28
4340,0,0,46,0,-46
4341,1,0,16,0,-16
4342,0,0,244,0,-244
4343,1,0,15,0,-15
4344,1,1,1021,1969,948
4345,0,0,45,0,-45
4346,0,0,44,0,-44
4347,1,0,105,0,-105
4348,1,1,1730,1222,-508
4349,0,0,5,0,-5
4350,0,0,73,0,-73
4351,1,1,1086,2656,1570
4352,0,0,6,0,-6
4353,1,0,25,0,-25
4354,0,0,84,0,-84
4355,0,0,99,0,-99
4356,0,0,91,0,-91
4357,1,1,457,2098,1641
4358,1,0,15,0,-15
4359,0,0,70,0,-70
4360,0,0,9,0,-9
4361,0,0,12,0,-12
4362,1,0,15,0,-15
4363,0,0,42,0,-42
4364,1,0,42,0,-42
4365,1,0,27,0,-27
4366,0,0,97,0,-97
4367,0,0,118,0,-118
4368,0,0,32,0,-32
4369,1,1,294,1415,1121
4370,1,1,1104,1389,285
4371,1,1,8,1286,1278
4372,1,1,61,1294,1233
4373,0,0,91,0,-91
4374,1,0,45,0,-45
4375,0,0,51,0,-51
4376,0,0,11,0,-11
4377,1,0,29,0,-29
4378,0,0,90,0,-90
4379,0,0,1,0,-1
4380,0,0,180,0,-180
4381,1,1,31,1948,1917
4382,0,0,5,0,-5
4383,0,0,148,0,-148
4384,0,0,181,0,-181
4385,1,0,23,0,-23
4386,1,1,1301,1825,524
4387,0,0,56,0,-56
4388,0,0,102,0,-102
4389,1,1,1247,1222,-25
4390,0,0,77,0,-77
4391,0,0,149,0,-149
4392,0,0,21,0,-21
4393,1,1,1167,1225,58
4394,0,0,57,0,-57
4395,1,0,43,0,-43
4396,0,0,11,0,-11
4397,1,0,43,0,-43
4398,1,0,1,0,-1
4399,1,1,2118,1465,-653
4400,1,1,44,2196,2152
4401,1,1,104,1417,1313
4402,0,0,11,0,-11
4403,0,0,4,0,-4
4404,0,0,1,0,-1
4405,1,0,10,0,-10
4406,1,1,267,1570,1303
4407,1,1,299,2380,2081
4408,1,0,60,0,-60
4409,0,0,90,0,-90
4410,0,0,8,0,-8
4411,0,0,38,0,-38
4412,1,1,814,2474,1660
4413,0,0,55,0,-55
4414,1,0,12,0,-12
4415,1,0,7,0,-7
4416,1,0,116,0,-116
4417,1,0,257,0,-257
4418,1,0,34,0,-34
4419,1,0,0,0,0
4420,1,0,10,0,-10
4421,1,1,846,1310,464
4422,1,0,81,0,-81
4423,1,1,547,1375,828
4424,0,0,111,0,-111
4425,1,0,85,0,-85
4426,0,0,53,0,-53
4427,1,0,18,0,-18
4428,1,0,13,0,-13
4429,1,0,38,0,-38
4430,1,0,4,0,-4
4431,1,1,140,1947,1807
4432,1,0,17,0,-17
4433,1,1,338,1212,874
4434,0,0,53,0,-53
4435,1,0,22,0,-22
4436,0,0,61,0,-61
4437,1,1,197,1851,1654
4438,1,1,129,1431,1302
4439,1,0,23,0,-23
4440,1,0,11,0,-11
4441,1,1,146,3598,3452
4442,0,0,78,0,-78
4443,1,0,16,0,-16
4444,0,0,19,0,-19
4445,0,0,18,0,-18
4446,0,0,57,0,-57
4447,1,0,181,0,-181
4448,1,0,28,0,-28
4449,0,0,14,0,-14
4450,1,0,17,0,-17
4451,1,0,127,0,-127
4452,0,0,5,0,-5
4453,0,0,31,0,-31
4454,1,1,62,1923,1861
4455,1,1,55,1413,1358
4456,1,1,479,1205,726
4457,1,1,285,2295,2010
4458,1,0,51,0,-51
4459,1,0,55,0,-55
4460,0,0,50,0,-50
4461,0,0,123,0,-123
4462,1,1,352,1779,1427
4463,1,0,37,0,-37
4464,1,1,510,1266,756
4465,1,1,864,1271,407
4466,1,1,263,1453,1190
4467,0,0,4,0,-4
4468,1,1,849,1544,695
4469,0,0,37,0,-37
4470,0,0,179,0,-179
4471,0,0,82,0,-82
4472,0,0,11,0,-11
4473,1,0,63,0,-63
4474,1,0,34,0,-34
4475,1,0,42,0,-42
4476,1,0,167,0,-167
4477,1,0,14,0,-14
4478,0,0,62,0,-62
4479,0,0,17,0,-17
4480,1,1,1527,1215,-312
4481,1,1,1053,1223,170
4482,1,0,9,0,-9
4483,1,0,47,0,-47
4484,1,1,231,1288,1057
4485,0,0,3,0,-3
4486,0,0,9,0,-9
4487,1,1,671,1309,638
4488,0,0,1,0,-1
4489,0,0,22,0,-22
4490,0,0,68,0,-68
4491,1,0,17,0,-17
4492,0,0,3,0,-3
4493,1,0,164,0,-164
4494,0,0,168,0,-168
4495,1,0,2,0,-2
4496,0,0,1,0,-1
4497,0,0,65,0,-65
4498,0,0,2,0,-2
4499,1,0,21,0,-21
4500,0,0,0,0,0
4501,1,1,348,1430,1082
4502,0,0,27,0,-27
4503,1,1,426,1202,776
4504,0,0,52,0,-52
4505,1,1,81,1885,1804
4506,0,0,41,0,-41
4507,0,0,25,0,-25
4508,0,0,24,0,-24
4509,0,0,111,0,-111
4510,1,1,534,1674,1140
4511,1,1,360,1687,1327
4512,1,1,887,1789,902
4513,1,1,253,1534,1281
4514,1,0,86,0,-86
4515,0,0,24,0,-24
4516,0,0,28,0,-28
4517,0,0,35,0,-35
4518,1,1,1761,1617,-144
4519,0,0,13,0,-13
4520,1,0,10,0,-10
4521,0,0,2,0,-2
4522,0,0,173,0,-173
4523,1,1,1429,1756,327
4524,1,1,1759,1939,180
4525,1,1,1354,1292,-62
4526,1,0,44,0,-44
4527,0,0,43,0,-43
4528,1,1,133,1880,1747
4529,1,0,4,0,-4
4530,0,0,16,0,-16
4531,1,0,13,0,-13
4532,1,0,17,0,-17
4533,1,0,23,0,-23
4534,0,0,37,0,-37
4535,1,1,420,1613,1193
4536,1,1,275,2065,1790
4537,0,0,92,0,-92
4538,0,0,22,0,-22
4539,1,0,37,0,-37
4540,1,1,158,2251,2093
4541,0,0,9,0,-9
4542,1,0,34,0,-34
4543,1,1,715,1372,657
4544,0,0,5,0,-5
4545,1,1,441,1304,863
4546,0,0,27,0,-27
4547,0,0,45,0,-45
4548,1,0,107,0,-107
4549,1,0,83,0,-83
4550,0,0,50,0,-50
4551,0,0,83,0,-83
4552,1,1,110,3495,3385
4553,1,1,280,1480,1200
4554,1,1,1646,2041,395
4555,1,0,37,0,-37
4556,1,0,15,0,-15
4557,1,1,776,1333,557
4558,1,0,14,0,-14
4559,0,0,0,0,0
4560,1,1,207,1263,1056
4561,0,0,20,0,-20
4562,0,0,125,0,-125
4563,0,0,4,0,-4
4564,1,0,50,0,-50
4565,0,0,21,0,-21
4566,1,0,6,0,-6
4567,1,0,69,0,-69
4568,0,0,3,0,-3
4569,1,0,28,0,-28
4570,0,0,30,0,-30
4571,0,0,41,0,-41
4572,1,0,137,0,-137
4573,1,1,1058,1649,591
4574,1,0,57,0,-57
4575,1,1,385,1332,947
4576,0,0,91,0,-91
4577,1,0,154,0,-154
4578,1,1,2912,1228,-1684
4579,1,0,26,0,-26
4580,1,1,693,1499,806
4581,0,0,45,0,-45
4582,0,0,210,0,-210
4583,1,0,2,0,-2
4584,1,1,53,1496,1443
4585,0,0,20,0,-20
4586,1,1,127,1647,1520
4587,0,0,36,0,-36
4588,0,0,38,0,-38
4589,0,0,17,0,-17
4590,1,1,355,1505,1150
4591,0,0,73,0,-73
4592,0,0,164,0,-164
4593,0,0,1,0,-1
4594,0,0,118,0,-118
4595,1,0,0,0,0
4596,1,1,136,1351,1215
4597,1,1,368,1936,1568
4598,1,0,7,0,-7
4599,1,1,503,1531,1028
4600,0,0,38,0,-38
4601,1,1,497,1375,878
4602,1,1,976,1486,510
4603,1,0,49,0,-49
4604,0,0,35,0,-35
4605,1,1,75,1646,1571
4606,1,0,2,0,-2
4607,1,0,25,0,-25
4608,0,0,56,0,-56
4609,0,0,170,0,-170
4610,1,0,30,0,-30
4611,1,0,48,0,-48
4612,1,1,471,1260,789
4613,0,0,2,0,-2
4614,1,1,63,1289,1226
4615,1,1,353,1581,1228
4616,1,0,99,0,-99
4617,1,0,10,0,-10
4618,1,0,12,0,-12
4619,1,1,532,2828,2296
4620,1,0,13,0,-13
4621,0,0,99,0,-99
4622,0,0,31,0,-31
4623,0,0,26,0,-26
4624,1,0,61,0,-61
4625,1,0,115,0,-115
4626,1,1,394,3467,3073
4627,1,1,1357,2135,778
4628,0,0,55,0,-55
4629,1,1,639,1325,686
4630,1,1,948,1558,610
4631,1,0,32,0,-32
4632,1,0,10,0,-10
4633,1,1,128,1261,1133
4634,1,1,908,1450,542
4635,1,1,262,1308,1046
4636,0,0,53,0,-53
4637,1,0,41,0,-41
4638,0,0,81,0,-81
4639,0,0,85,0,-85
4640,0,0,74,0,-74
4641,1,1,32,1234,1202
4642,1,1,287,1380,1093
4643,0,0,12,0,-12
4644,1,0,0,0,0
4645,1,0,49,0,-49
4646,1,0,23,0,-23
4647,0,0,127,0,-127
4648,1,1,680,1291,611
4649,1,0,31,0,-31
4650,1,1,1453,1656,203
4651,1,1,177,1980,1803
4652,1,0,23,0,-23
4653,1,1,198,1362,1164
4654,0,0,19,0,-19
4655,1,1,1049,2063,1014
4656,1,1,735,1307,572
4657,1,0,12,0,-12
4658,1,0,6,0,-6
4659,1,1,38,1214,1176
4660,0,0,18,0,-18
4661,0,0,85,0,-85
4662,1,0,47,0,-47
4663,0,0,87,0,-87
4664,0,0,18,0,-18
4665,1,1,495,1856,1361
4666,1,1,2219,1308,-911
4667,0,0,71,0,-71
4668,1,0,37,0,-37
4669,1,0,38,0,-38
4670,1,0,63,0,-63
4671,1,0,24,0,-24
4672,1,0,93,0,-93
4673,1,0,48,0,-48
4674,1,1,523,1242,719
4675,1,0,45,0,-45
4676,0,0,51,0,-51
4677,0,0,8,0,-8
4678,0,0,74,0,-74
4679,1,1,166,1607,1441
4680,0,0,105,0,-105
4681,1,1,2327,1302,-1025
4682,0,0,8,0,-8
4683,0,0,7,0,-7
4684,1,0,147,0,-147
4685,1,0,94,0,-94
4686,1,1,4,1454,1450
4687,1,1,1076,1405,329
4688,0,0,6,0,-6
4689,0,0,3,0,-3
4690,0,0,98,0,-98
4691,0,0,13,0,-13
4692,0,0,29,0,-29
4693,0,0,61,0,-61
4694,0,0,23,0,-23
4695,1,1,736,1392,656
4696,0,0,16,0,-16
4697,0,0,102,0,-102
4698,1,0,59,0,-59
4699,1,0,6,0,-6
4700,0,0,31,0,-31
4701,1,1,773,1209,436
4702,1,0,61,0,-61
4703,1,1,163,2180,2017
4704,0,0,21,0,-21
4705,1,0,25,0,-25
4706,1,0,45,0,-45
4707,1,0,42,0,-42
4708,0,0,183,0,-183
4709,1,1,404,1302,898
4710,1,0,5,0,-5
4711,0,0,8,0,-8
4712,1,1,513,1397,884
4713,0,0,107,0,-107
4714,1,0,68,0,-68
4715,0,0,0,0,0
4716,0,0,63,0,-63
4717,1,1,277,1274,997
4718,1,0,80,0,-80
4719,0,0,5,0,-5
4720,1,1,871,1387,516
4721,0,0,55,0,-55
4722,0,0,29,0,-29
4723,1,1,2427,1432,-995
4724,1,0,38,0,-38
4725,0,0,125,0,-125
4726,0,0,90,0,-90
4727,1,1,268,1343,1075
4728,1,1,1795,1421,-374
4729,1,0,57,0,-57
4730,0,0,70,0,-70
4731,0,0,3,0,-3
4732,1,1,211,1401,1190
4733,0,0,4,0,-4
4734,0,0,0,0,0
4735,1,0,24,0,-24
4736,0,0,3,0,-3
4737,1,0,61,0,-61
4738,1,0,25,0,-25
4739,1,1,782,1484,702
4740,1,0,31,0,-31
4741,1,1,548,1235,687
4742,0,0,38,0,-38
4743,0,0,55,0,-55
4744,1,0,10,0,-10
4745,1,1,503,1274,771
4746,1,0,20,0,-20
4747,0,0,58,0,-58
4748,1,1,62,1403,1341
4749,0,0,101,0,-101
4750,1,0,19,0,-19
4751,0,0,8,0,-8
4752,0,0,132,0,-132
4753,1,0,70,0,-70
4754,0,0,129,0,-129
4755,0,0,22,0,-22
4756,0,0,64,0,-64
4757,0,0,93,0,-93
4758,1,1,1350,1308,-42
4759,0,0,5,0,-5
4760,1,1,127,1441,1314
4761,1,0,69,0,-69
4762,1,1,591,1411,820
4763,1,0,37,0,-37
4764,1,0,29,0,-29
4765,1,1,48,2211,2163
4766,1,1,193,1274,1081
4767,1,0,68,0,-68
4768,1,0,7,0,-7
4769,1,0,38,0,-38
4770,1,0,30,0,-30
4771,0,0,40,0,-40
4772,1,1,1026,1209,183
4773,1,0,153,0,-153
4774,1,0,53,0,-53
4775,1,1,630,1226,596
4776,1,0,17,0,-17
4777,0,0,31,0,-31
4778,1,1,298,1726,1428
4779,1,0,30,0,-30
4780,0,0,113,0,-113
4781,1,1,61,1272,1211
4782,1,0,12,0,-12
4783,1,0,94,0,-94
4784,1,0,52,0,-52
4785,0,0,55,0,-55
4786,1,0,44,0,-44
4787,1,0,13,0,-13
4788,0,0,63,0,-63
4789,1,1,83,1488,1405
4790,1,0,27,0,-27
4791,1,0,92,0,-92
4792,0,0,39,0,-39
4793,0,0,11,0,-11
4794,1,1,512,3775,3263
4795,1,0,128,0,-128
4796,1,0,64,0,-64
4797,0,0,9,0,-9
4798,1,0,11,0,-11
4799,0,0,101,0,-101
4800,1,1,285,1524,1239
4801,0,0,40,0,-40
4802,1,1,386,1687,1301
4803,0,0,81,0,-81
4804,1,1,724,1354,630
4805,0,0,27,0,-27
4806,1,0,36,0,-36
4807,0,0,24,0,-24
4808,1,1,509,1357,848
4809,0,0,32,0,-32
4810,0,0,30,0,-30
4811,1,0,61,0,-61
4812,0,0,36,0,-36
4813,0,0,15,0,-15
4814,1,1,1576,1606,30
4815,0,0,9,0,-9
4816,0,0,55,0,-55
4817,1,1,113,1316,1203
4818,0,0,22,0,-22
4819,0,0,38,0,-38
4820,1,1,396,1325,929
4821,0,0,40,0,-40
4822,1,0,188,0,-188
4823,1,1,535,1221,686
4824,0,0,30,0,-30
4825,0,0,27,0,-27
4826,0,0,107,0,-107
4827,1,1,624,1350,726
4828,0,0,188,0,-188
4829,1,1,722,1809,1087
4830,0,0,71,0,-71
4831,0,0,10,0,-10
4832,1,0,7,0,-7
4833,0,0,65,0,-65
4834,0,0,20,0,-20
4835,1,1,80,1203,1123
4836,1,0,106,0,-106
4837,0,0,66,0,-66
4838,0,0,2,0,-2
4839,1,0,9,0,-9
4840,0,0,141,0,-141
4841,1,1,1659,1515,-144
4842,1,0,140,0,-140
4843,0,0,21,0,-21
4844,1,1,156,1667,1511
4845,1,0,158,0,-158
4846,1,0,102,0,-102
4847,1,0,8,0,-8
4848,1,1,74,1282,1208
4849,1,0,67,0,-67
4850,1,0,1,0,-1
4851,0,0,10,0,-10
4852,1,1,280,1207,927
4853,0,0,49,0,-49
4854,1,0,51,0,-51
4855,0,0,39,0,-39
4856,1,1,571,1368,797
4857,0,0,109,0,-109
4858,1,0,0,0,0
4859,0,0,22,0,-22
4860,1,1,226,2167,1941
4861,1,0,5,0,-5
4862,1,1,218,1290,1072
4863,1,0,64,0,-64
4864,1,1,480,1258,778
4865,1,0,87,0,-87
4866,0,0,71,0,-71
4867,1,1,612,1412,800
4868,1,0,81,0,-81
4869,1,0,54,0,-54
4870,1,1,326,1469,1143
4871,1,1,518,1543,1025
4872,1,1,214,1312,1098
4873,1,0,80,0,-80
4874,0,0,29,0,-29
4875,0,0,12,0,-12
4876,1,0,80,0,-80
4877,0,0,24,0,-24
4878,0,0,20,0,-20
4879,1,1,1059,1280,221
4880,1,0,63,0,-63
4881,1,1,269,1943,1674
4882,0,0,19,0,-19
4883,1,0,110,0,-110
4884,1,1,736,2660,1924
4885,1,0,27,0,-27
4886,1,0,95,0,-95
4887,1,1,161,1526,1365
4888,1,1,245,1469,1224
4889,0,0,175,0,-175
4890,1,1,611,1460,849
4891,0,0,3,0,-3
4892,0,0,11,0,-11
4893,1,1,281,1245,964
4894,1,0,66,0,-66
4895,1,0,23,0,-23
4896,1,0,4,0,-4
4897,1,0,0,0,0
4898,0,0,97,0,-97
4899,1,0,1,0,-1
4900,0,0,73,0,-73
4901,0,0,5,0,-5
4902,0,0,55,0,-55
4903,1,1,327,1842,1515
4904,1,1,75,1294,1219
4905,1,1,346,1901,1555
4906,0,0,5,0,-5
4907,1,0,0,0,0
4908,0,0,8,0,-8
4909,1,0,365,0,-365
4910,1,1,538,1377,839
4911,0,0,33,0,-33
4912,1,0,3,0,-3
4913,1,1,664,2337,1673
4914,0,0,47,0,-47
4915,0,0,46,0,-46
4916,1,0,18,0,-18
4917,0,0,27,0,-27
4918,0,0,1,0,-1
4919,1,1,297,1651,1354
4920,1,1,509,1934,1425
4921,1,0,141,0,-141
4922,1,1,627,1367,740
4923,1,1,354,1277,923
4924,0,0,85,0,-85
4925,0,0,46,0,-46
4926,0,0,20,0,-20
4927,0,0,13,0,-13
4928,0,0,0,0,0
4929,0,0,35,0,-35
4930,1,1,853,1573,720
4931,0,0,126,0,-126
4932,1,1,995,1729,734
4933,1,0,10,0,-10
4934,0,0,7,0,-7
4935,1,1,1336,1338,2
4936,0,0,21,0,-21
4937,1,0,78,0,-78
4938,1,1,1291,1890,599
4939,1,1,670,1294,624
4940,0,0,1,0,-1
4941,0,0,19,0,-19
4942,0,0,5,0,-5
4943,0,0,97,0,-97
4944,1,0,8,0,-8
4945,0,0,72,0,-72
4946,0,0,52,0,-52
4947,1,0,48,0,-48
4948,1,0,105,0,-105
4949,1,1,228,1670,1442
4950,1,1,180,1231,1051
4951,1,0,90,0,-90
4952,0,0,43,0,-43
4953,1,0,35,0,-35
4954,0,0,9,0,-9
4955,1,0,59,0,-59
4956,1,1,200,1626,1426
4957,0,0,70,0,-70
4958,1,0,46,0,-46
4959,1,1,212,1391,1179
4960,0,0,73,0,-73
4961,0,0,13,0,-13
4962,1,1,321,1399,1078
4963,1,1,110,3416,3306
4964,1,0,25,0,-25
4965,1,1,102,1369,1267
4966,1,1,358,1651,1293
4967,1,0,29,0,-29
4968,0,0,0,0,0
4969,1,0,54,0,-54
4970,0,0,282,0,-282
4971,1,0,3,0,-3
4972,0,0,93,0,-93
4973,1,1,1578,1375,-203
4974,1,1,319,1279,960
4975,1,0,133,0,-133
4976,0,0,75,0,-75
4977,0,0,90,0,-90
4978,1,1,242,1450,1208
4979,0,0,14,0,-14
4980,1,0,77,0,-77
4981,1,0,286,0,-286
4982,0,0,25,0,-25
4983,1,0,124,0,-124
4984,0,0,152,0,-152
4985,1,0,16,0,-16
4986,0,0,66,0,-66
4987,1,0,55,0,-55
4988,1,1,203,1599,1396
4989,1,0,44,0,-44
4990,0,0,2,0,-2
4991,0,0,45,0,-45
4992,1,1,571,1746,1175
4993,0,0,26,0,-26
4994,1,1,224,1477,1253
4995,1,0,5,0,-5
4996,0,0,121,0,-121
4997,1,0,32,0,-32
4998,0,0,31,0,-31
4999,1,0,34,0,-34
5000,1,0,16,0,-16
5001,0,0,12,0,-12
5002,1,0,38,0,-38
5003,0,0,55,0,-55
5004,1,1,374,1348,974
5005,0,0,171,0,-171
5006,0,0,22,0,-22
5007,1,0,31,0,-31
5008,0,0,185,0,-185
5009,0,0,32,0,-32
5010,0,0,2,0,-2
5011,1,1,1348,1824,476
5012,1,0,23,0,-23
5013,1,1,68,1357,1289
5014,0,0,20,0,-20
5015,0,0,81,0,-81
5016,0,0,67,0,-67
5017,1,1,449,1440,991
5018,1,1,29,1575,1546
5019,1,1,647,1237,590
5020,1,1,72,1646,1574
5021,1,1,198,1235,1037
5022,0,0,65,0,-65
5023,0,0,15,0,-15
5024,1,1,542,1370,828
5025,1,1,916,1283,367
5026,1,1,1635,1602,-33
5027,1,1,402,2700,2298
5028,1,0,13,0,-13
5029,1,1,984,2710,1726
5030,0,0,46,0,-46
5031,1,0,140,0,-140
5032,1,1,490,1313,823
5033,0,0,71,0,-71
5034,1,1,241,1366,1125
5035,1,1,102,1205,1103
5036,1,1,546,1253,707
5037,1,1,1177,1531,354
5038,0,0,7,0,-7
5039,0,0,20,0,-20
5040,0,0,54,0,-54
5041,1,0,20,0,-20
5042,1,0,89,0,-89
5043,1,1,783,2627,1844
5044,0,0,34,0,-34
5045,1,0,40,0,-40
5046,1,0,65,0,-65
5047,1,1,1647,1216,-431
5048,0,0,7,0,-7
5049,1,0,145,0,-145
5050,1,1,273,1500,1227
5051,1,1,183,1263,1080
5052,1,1,198,1342,1144
5053,1,0,97,0,-97
5054,1,1,716,1643,927
5055,1,1,363,1222,859
5056,1,1,266,1225,959
5057,1,1,468,1349,881
5058,1,0,29,0,-29
5059,0,0,26,0,-26
5060,0,0,11,0,-11
5061,0,0,189,0,-189
5062,0,0,13,0,-13
5063,0,0,20,0,-20
5064,0,0,16,0,-16
5065,1,1,209,1418,1209
5066,0,0,42,0,-42
5067,1,0,39,0,-39
5068,0,0,44,0,-44
5069,0,0,103,0,-103
5070,1,1,487,1809,1322
5071,1,0,114,0,-114
5072,0,0,73,0,-73
5073,0,0,32,0,-32
5074,1,0,77,0,-77
5075,1,1,1547,2107,560
5076,1,0,11,0,-11
5077,1,1,419,1303,884
5078,1,1,1494,1611,117
5079,0,0,16,0,-16
5080,1,0,134,0,-134
5081,0,0,34,0,-34
5082,0,0,44,0,-44
5083,1,0,107,0,-107
5084,1,0,29,0,-29
5085,1,1,190,1269,1079
5086,1,1,80,1595,1515
5087,0,0,35,0,-35
5088,0,0,217,0,-217
5089,1,0,74,0,-74
5090,0,0,14,0,-14
5091,0,0,16,0,-16
5092,1,0,7,0,-7
5093,0,0,104,0,-104
5094,0,0,18,0,-18
5095,0,0,172,0,-172
5096,0,0,4,0,-4
5097,0,0,138,0,-138
5098,0,0,4,0,-4
5099,0,0,148,0,-148
5100,1,0,61,0,-61
5101,0,0,60,0,-60
5102,1,1,627,1566,939
5103,0,0,19,0,-19
5104,0,0,51,0,-51
5105,1,0,37,0,-37
5106,1,1,455,1789,1334
5107,1,1,67,1310,1243
5108,1,0,19,0,-19
5109,1,1,703,1483,780
5110,0,0,22,0,-22
5111,1,1,390,1391,1001
5112,1,1,843,1631,788
5113,1,0,18,0,-18
5114,1,1,104,1634,1530
5115,0,0,3,0,-3
5116,1,0,45,0,-45
5117,1,0,6,0,-6
5118,0,0,8,0,-8
5119,1,1,576,2812,2236
5120,1,1,599,2486,1887
5121,1,0,36,0,-36
5122,0,0,1,0,-1
5123,0,0,254,0,-254
5124,0,0,79,0,-79
5125,1,1,109,2051,1942
5126,0,0,113,0,-113
5127,0,0,49,0,-49
5128,1,0,216,0,-216
5129,0,0,113,0,-113
5130,1,1,1094,1233,139
5131,1,0,12,0,-12
5132,1,1,338,1962,1624
5133,1,1,1375,1569,194
5134,1,1,205,2379,2174
5135,0,0,83,0,-83
5136,1,1,1243,1533,290
5137,0,0,15,0,-15
5138,0,0,24,0,-24
5139,0,0,21,0,-21
5140,0,0,3,0,-3
5141,1,0,133,0,-133
5142,1,0,57,0,-57
5143,1,0,26,0,-26
5144,0,0,53,0,-53
5145,1,0,192,0,-192
5146,0,0,102,0,-102
5147,1,1,397,1504,1107
5148,1,0,16,0,-16
5149,1,0,9,0,-9
5150,0,0,121,0,-121
5151,0,0,14,0,-14
5152,1,1,423,3238,2815
5153,1,1,791,1208,417
5154,0,0,136,0,-136
5155,0,0,37,0,-37
5156,0,0,97,0,-97
5157,1,0,63,0,-63
5158,1,1,485,1264,779
5159,0,0,5,0,-5
5160,0,0,23,0,-23
5161,1,1,456,1404,948
5162,1,0,13,0,-13
5163,1,1,579,1233,654
5164,0,0,25,0,-25
5165,1,1,301,1426,1125
5166,1,0,10,0,-10
5167,0,0,23,0,-23
5168,1,1,732,2206,1474
5169,1,1,112,3021,2909
5170,0,0,115,0,-115
5171,1,0,31,0,-31
5172,0,0,3,0,-3
5173,0,0,74,0,-74
5174,1,0,23,0,-23
5175,1,0,5,0,-5
5176,1,1,408,1816,1408
5177,1,1,484,1307,823
5178,1,1,125,1662,1537
5179,1,1,117,1465,1348
5180,1,1,215,1304,1089
5181,1,0,44,0,-44
5182,0,0,10,0,-10
5183,0,0,57,0,-57
5184,0,0,9,0,-9
5185,1,1,245,1697,1452
5186,1,0,21,0,-21
5187,0,0,10,0,-10
5188,1,1,1199,1361,162
5189,1,0,51,0,-51
5190,1,0,31,0,-31
5191,1,1,253,1637,1384
5192,1,0,36,0,-36
5193,1,0,17,0,-17
5194,1,0,32,0,-32
5195,0,0,10,0,-10
5196,0,0,32,0,-32
5197,1,1,1598,1237,-361
5198,1,1,46,1402,1356
5199,1,1,323,1292,969
5200,1,1,78,1311,1233
5201,0,0,3,0,-3
5202,1,1,577,1693,1116
5203,1,1,188,1437,1249
5204,0,0,75,0,-75
5205,1,0,8,0,-8
5206,1,1,946,1391,445
5207,1,1,858,3581,2723
5208,1,1,1749,1364,-385
5209,1,0,0,0,0
5210,0,0,56,0,-56
5211,1,0,76,0,-76
5212,1,1,1427,1627,200
5213,1,1,158,1214,1056
5214,1,0,19,0,-19
5215,1,1,769,1218,449
5216,0,0,67,0,-67
5217,1,1,665,1567,902
5218,1,1,158,2190,2032
5219,0,0,84,0,-84
5220,0,0,109,0,-109
5221,1,1,252,1496,1244
5222,0,0,116,0,-116
5223,0,0,69,0,-69
5224,1,1,120,6638,6518
5225,1,0,101,0,-101
5226,1,1,351,1629,1278
5227,1,1,70,1289,1219
5228,0,0,12,0,-12
5229,0,0,2,0,-2
5230,0,0,37,0,-37
5231,1,1,255,1294,1039
5232,0,0,94,0,-94
5233,0,0,25,0,-25
5234,0,0,8,0,-8
5235,1,0,12,0,-12
5236,1,0,51,0,-51
5237,0,0,79,0,-79
5238,0,0,2,0,-2
5239,1,1,418,1707,1289
5240,0,0,104,0,-104
5241,0,0,11,0,-11
5242,1,1,1363,1275,-88
5243,1,0,282,0,-282
5244,0,0,17,0,-17
5245,0,0,147,0,-147
5246,1,0,79,0,-79
5247,0,0,36,0,-36
5248,0,0,123,0,-123
5249,0,0,244,0,-244
5250,0,0,115,0,-115
5251,1,1,50,1350,1300
5252,1,1,232,1929,1697
5253,1,1,271,1431,1160
5254,0,0,2,0,-2
5255,1,1,278,1967,1689
5256,0,0,26,0,-26
5257,1,1,585,1221,636
5258,1,0,5,0,-5
5259,0,0,27,0,-27
5260,0,0,45,0,-45
5261,0,0,76,0,-76
5262,1,1,800,1321,521
5263,1,0,10,0,-10
5264,1,1,1463,1295,-168
5265,1,1,354,1453,1099
5266,1,1,213,1227,1014
5267,0,0,44,0,-44
5268,0,0,101,0,-101
5269,1,1,94,1329,1235
5270,0,0,34,0,-34
5271,1,1,522,1645,1123
5272,0,0,22,0,-22
5273,1,0,40,0,-40
5274,1,1,381,1425,1044
5275,0,0,8,0,-8
5276,0,0,27,0,-27
5277,1,0,8,0,-8
5278,0,0,32,0,-32
5279,1,0,16,0,-16
5280,1,0,53,0,-53
5281,0,0,20,0,-20
5282,1,0,35,0,-35
5283,1,0,82,0,-82
5284,0,0,175,0,-175
5285,1,1,810,1369,559
5286,1,0,2,0,-2
5287,0,0,14,0,-14
5288,0,0,119,0,-119
5289,1,0,70,0,-70
5290,0,0,33,0,-33
5291,1,0,85,0,-85
5292,0,0,28,0,-28
5293,1,0,258,0,-258
5294,1,0,104,0,-104
5295,0,0,132,0,-132
5296,1,1,1158,1855,697
5297,1,1,73,1430,1357
5298,1,0,80,0,-80
5299,1,0,49,0,-49
5300,0,0,3,0,-3
5301,1,0,13,0,-13
5302,1,1,774,1761,987
5303,1,0,22,0,-22
5304,1,0,112,0,-112
5305,0,0,41,0,-41
5306,0,0,28,0,-28
5307,0,0,12,0,-12
5308,1,0,18,0,-18
5309,0,0,76,0,-76
5310,1,1,134,1480,1346
5311,1,1,817,2107,1290
5312,1,1,276,1680,1404
5313,0,0,55,0,-55
5314,1,0,46,0,-46
5315,1,0,73,0,-73
5316,1,1,37,1285,1248
5317,1,0,21,0,-21
5318,0,0,6,0,-6
5319,1,0,3,0,-3
5320,1,0,29,0,-29
5321,1,1,978,1226,248
5322,1,1,460,1494,1034
5323,0,0,5,0,-5
5324,1,0,86,0,-86
5325,1,0,15,0,-15
5326,1,0,49,0,-49
5327,1,0,52,0,-52
5328,1,0,89,0,-89
5329,1,0,5,0,-5
5330,1,1,469,2423,1954
5331,1,1,514,1942,1428
5332,1,1,493,1525,1032
5333,0,0,99,0,-99
5334,1,1,137,1658,1521
5335,0,0,22,0,-22
5336,0,0,0,0,0
5337,1,1,146,1458,1312
5338,1,1,617,1531,914
5339,1,1,44,3341,3297
5340,1,1,39,1290,1251
5341,0,0,80,0,-80
5342,1,1,273,1815,1542
5343,0,0,52,0,-52
5344,1,0,29,0,-29
5345,1,1,1061,3128,2067
5346,1,0,102,0,-102
5347,0,0,32,0,-32
5348,1,1,814,5198,4384
5349,1,0,41,0,-41
5350,1,1,43,1202,1159
5351,0,0,40,0,-40
5352,0,0,167,0,-167
5353,1,1,137,1206,1069
5354,1,1,867,1248,381
5355,0,0,32,0,-32
5356,1,0,47,0,-47
5357,1,0,56,0,-56
5358,0,0,82,0,-82
5359,0,0,88,0,-88
5360,1,0,92,0,-92
5361,1,0,58,0,-58
5362,1,0,61,0,-61
5363,0,0,63,0,-63
5364,1,0,22,0,-22
5365,1,1,886,1760,874
5366,1,0,97,0,-97
5367,1,1,249,2138,1889
5368,0,0,79,0,-79
5369,1,0,87,0,-87
5370,1,0,66,0,-66
5371,0,0,128,0,-128
5372,0,0,43,0,-43
5373,0,0,56,0,-56
5374,0,0,46,0,-46
5375,0,0,27,0,-27
5376,0,0,3,0,-3
5377,0,0,11,0,-11
5378,1,1,167,1238,1071
5379,1,0,62,0,-62
5380,1,0,52,0,-52
5381,1,0,81,0,-81
5382,0,0,82,0,-82
5383,1,0,29,0,-29
5384,1,0,5,0,-5
5385,1,0,154,0,-154
5386,1,0,142,0,-142
5387,1,0,132,0,-132
5388,1,0,36,0,-36
5389,0,0,91,0,-91
5390,1,1,1435,1446,11
5391,1,1,161,2346,2185
5392,1,1,768,1427,659
5393,1,1,356,1412,1056
5394,1,1,149,1339,1190
5395,0,0,25,0,-25
5396,1,0,54,0,-54
5397,1,0,22,0,-22
5398,0,0,127,0,-127
5399,0,0,12,0,-12
5400,1,1,181,1240,1059
5401,1,1,1269,1394,125
5402,1,0,143,0,-143
5403,0,0,28,0,-28
5404,1,0,37,0,-37
5405,1,0,59,0,-59
5406,1,0,49,0,-49
5407,1,0,12,0,-12
5408,1,1,1003,1275,272
5409,1,0,129,0,-129
5410,1,1,149,1296,1147
5411,0,0,10,0,-10
5412,0,0,46,0,-46
5413,1,0,1,0,-1
5414,0,0,137,0,-137
5415,1,0,28,0,-28
5416,0,0,31,0,-31
5417,1,1,161,1660,1499
5418,0,0,232,0,-232
5419,0,0,155,0,-155
5420,1,0,7,0,-7
5421,1,0,9,0,-9
5422,1,1,111,1222,1111
5423,1,1,418,1623,1205
5424,1,0,26,0,-26
5425,1,0,50,0,-50
5426,0,0,25,0,-25
5427,1,0,64,0,-64
5428,0,0,19,0,-19
5429,1,0,15,0,-15
5430,1,1,1152,2408,1256
5431,0,0,155,0,-155
5432,1,0,4,0,-4
5433,0,0,67,0,-67
5434,1,1,227,1450,1223
5435,1,0,59,0,-59
5436,0,0,50,0,-50
5437,1,1,95,1513,1418
5438,1,1,268,1221,953
5439,1,1,732,1206,474
5440,0,0,57,0,-57
5441,1,1,344,1424,1080
5442,1,0,27,0,-27
5443,1,1,282,1259,977
5444,0,0,9,0,-9
5445,0,0,27,0,-27
5446,1,1,788,1593,805
5447,1,0,160,0,-160
5448,0,0,99,0,-99
5449,1,0,18,0,-18
5450,0,0,49,0,-49
5451,1,0,103,0,-103
5452,1,0,5,0,-5
5453,1,0,9,0,-9
5454,0,0,153,0,-153
5455,1,1,475,1203,728
5456,1,1,306,1271,965
5457,1,0,39,0,-39
5458,0,0,26,0,-26
5459,0,0,8,0,-8
5460,0,0,37,0,-37
5461,1,0,61,0,-61
5462,0,0,0,0,0
5463,1,1,85,1306,1221
5464,1,1,1038,1217,179
5465,1,1,736,1736,1000
5466,1,1,549,1871,1322
5467,1,0,48,0,-48
5468,1,0,65,0,-65
5469,1,1,64,1248,1184
5470,1,0,227,0,-227
5471,1,1,482,1611,1129
5472,1,1,1021,1480,459
5473,1,1,63,3126,3063
5474,1,0,68,0,-68
5475,1,1,234,1896,1662
5476,1,0,124,0,-124
5477,0,0,138,0,-138
5478,0,0,102,0,-102
5479,0,0,102,0,-102
5480,0,0,8,0,-8
5481,0,0,48,0,-48
5482,0,0,72,0,-72
5483,1,1,277,1971,1694
5484,0,0,8,0,-8
5485,0,0,242,0,-242
5486,0,0,94,0,-94
5487,1,1,123,1430,1307
5488,0,0,54,0,-54
5489,0,0,84,0,-84
5490,1,0,56,0,-56
5491,1,1,882,1280,398
5492,1,0,34,0,-34
5493,0,0,28,0,-28
5494,0,0,35,0,-35
5495,0,0,137,0,-137
5496,0,0,15,0,-15
5497,1,1,530,1282,752
5498,1,1,30,1352,1322
5499,1,1,431,1976,1545
5500,0,0,20,0,-20
5501,1,1,1061,1612,551
5502,0,0,17,0,-17
5503,0,0,31,0,-31
5504,0,0,22,0,-22
5505,1,0,110,0,-110
5506,1,0,50,0,-50
5507,1,1,309,1247,938
5508,1,1,1292,1396,104
5509,1,0,6,0,-6
5510,1,1,504,1238,734
5511,0,0,25,0,-25
5512,1,0,1,0,-1
5513,0,0,59,0,-59
5514,0,0,36,0,-36
5515,1,1,470,1214,744
5516,1,0,57,0,-57
5517,1,1,565,1385,820
5518,0,0,3,0,-3
5519,1,1,362,1265,903
5520,1,0,237,0,-237
5521,1,1,905,1319,414
5522,1,1,694,1257,563
5523,0,0,50,0,-50
5524,1,0,109,0,-109
5525,0,0,107,0,-107
5526,0,0,9,0,-9
5527,0,0,31,0,-31
5528,1,0,23,0,-23
5529,0,0,117,0,-117
5530,1,0,45,0,-45
5531,1,0,69,0,-69
5532,1,0,87,0,-87
5533,1,1,1264,1283,19
5534,0,0,13,0,-13
5535,1,1,334,1203,869
5536,1,0,139,0,-139
5537,0,0,98,0,-98
5538,1,0,8,0,-8
5539,0,0,3,0,-3
5540,0,0,60,0,-60
5541,1,1,184,1254,1070
5542,1,1,798,3120,2322
5543,1,1,720,1265,545
5544,1,1,62,1568,1506
5545,0,0,112,0,-112
5546,1,1,250,1932,1682
5547,1,1,124,1398,1274
5548,1,0,44,0,-44
5549,0,0,1,0,-1
5550,0,0,124,0,-124
5551,0,0,133,0,-133
5552,1,1,444,1584,1140
5553,0,0,17,0,-17
5554,0,0,12,0,-12
5555,0,0,8,0,-8
5556,0,0,46,0,-46
5557,1,1,52,1761,1709
5558,1,0,37,0,-37
5559,0,0,6,0,-6
5560,1,1,609,1336,727
5561,0,0,1,0,-1
5562,1,0,5,0,-5
5563,0,0,138,0,-138
5564,0,0,38,0,-38
5565,0,0,93,0,-93
5566,1,0,38,0,-38
5567,1,1,523,1513,990
5568,0,0,53,0,-53
5569,1,0,6,0,-6
5570,1,0,7,0,-7
5571,0,0,3,0,-3
5572,0,0,14,0,-14
5573,1,1,1936,1548,-388
5574,1,1,954,1274,320
5575,1,0,48,0,-48
5576,1,1,474,1907,1433
5577,1,0,133,0,-133
5578,0,0,4,0,-4
5579,1,1,448,1275,827
5580,1,0,26,0,-26
5581,1,1,20,1202,1182
5582,1,1,536,1309,773
5583,1,0,59,0,-59
5584,1,1,353,1246,893
5585,0,0,24,0,-24
5586,0,0,16,0,-16
5587,1,1,345,1311,966
5588,0,0,99,0,-99
5589,0,0,148,0,-148
5590,0,0,53,0,-53
5591,0,0,45,0,-45
5592,1,0,36,0,-36
5593,0,0,2,0,-2
5594,1,0,12,0,-12
5595,0,0,49,0,-49
5596,0,0,223,0,-223
5597,0,0,3,0,-3
5598,1,1,82,1876,1794
5599,0,0,61,0,-61
5600,0,0,21,0,-21
5601,1,1,331,1427,1096
5602,1,1,505,2060,1555
5603,0,0,65,0,-65
5604,1,1,175,1513,1338
5605,1,0,113,0,-113
5606,1,0,15,0,-15
5607,0,0,11,0,-11
5608,0,0,66,0,-66
5609,0,0,17,0,-17
5610,1,1,156,1640,1484
5611,1,1,720,2006,1286
5612,1,0,86,0,-86
5613,1,0,29,0,-29
5614,1,0,64,0,-64
5615,0,0,21,0,-21
5616,0,0,69,0,-69
5617,0,0,18,0,-18
5618,1,0,14,0,-14
5619,1,1,423,17742,17319
5620,1,0,2,0,-2
5621,1,1,36,1271,1235
5622,1,1,127,1361,1234
5623,1,1,577,1306,729
5624,0,0,27,0,-27
5625,1,1,140,1269,1129
5626,1,0,49,0,-49
5627,1,0,56,0,-56
5628,1,1,615,1536,921
5629,0,0,69,0,-69
5630,1,1,204,1218,1014
5631,1,0,63,0,-63
5632,1,1,217,1262,1045
5633,1,0,49,0,-49
5634,1,1,1231,1484,253
5635,1,1,739,1825,1086
5636,1,0,74,0,-74
5637,1,0,106,0,-106
5638,1,0,21,0,-21
5639,1,1,1967,1797,-170
5640,0,0,49,0,-49
5641,1,1,2107,2254,147
5642,0,0,51,0,-51
5643,0,0,19,0,-19
5644,0,0,40,0,-40
5645,1,0,70,0,-70
5646,0,0,75,0,-75
5647,0,0,28,0,-28
5648,1,1,135,1207,1072
5649,1,1,129,1718,1589
5650,1,0,1,0,-1
5651,0,0,40,0,-40
5652,0,0,19,0,-19
5653,0,0,13,0,-13
5654,0,0,14,0,-14
5655,1,0,11,0,-11
5656,0,0,128,0,-128
5657,1,1,1145,1369,224
5658,1,1,1613,2211,598
5659,1,0,90,0,-90
5660,0,0,16,0,-16
5661,0,0,61,0,-61
5662,0,0,0,0,0
5663,1,1,738,1287,549
5664,0,0,9,0,-9
5665,0,0,332,0,-332
5666,0,0,3,0,-3
5667,0,0,41,0,-41
5668,1,0,76,0,-76
5669,0,0,43,0,-43
5670,1,1,233,1349,1116
5671,0,0,2,0,-2
5672,1,0,105,0,-105
5673,0,0,15,0,-15
5674,0,0,52,0,-52
5675,0,0,132,0,-132
5676,1,0,25,0,-25
5677,0,0,91,0,-91
5678,1,0,74,0,-74
5679,1,0,58,0,-58
5680,1,0,53,0,-53
5681,1,1,40,1247,1207
5682,0,0,13,0,-13
5683,0,0,3,0,-3
5684,1,0,65,0,-65
5685,0,0,27,0,-27
5686,0,0,77,0,-77
5687,1,1,497,2601,2104
5688,0,0,59,0,-59
5689,1,1,169,2762,2593
5690,1,1,303,1540,1237
5691,0,0,14,0,-14
5692,1,1,399,1466,1067
5693,0,0,79,0,-79
5694,0,0,74,0,-74
5695,1,0,5,0,-5
5696,1,0,157,0,-157
5697,0,0,39,0,-39
5698,0,0,137,0,-137
5699,1,0,19,0,-19
5700,0,0,95,0,-95
5701,1,1,371,1540,1169
5702,0,0,37,0,-37
5703,1,0,44,0,-44
5704,0,0,94,0,-94
5705,1,1,84,1601,1517
5706,0,0,282,0,-282
5707,0,0,3,0,-3
5708,1,1,771,1363,592
5709,1,1,543,3182,2639
5710,0,0,62,0,-62
5711,1,0,19,0,-19
5712,0,0,26,0,-26
5713,1,0,372,0,-372
5714,1,0,49,0,-49
5715,1,1,251,1473,1222
5716,0,0,35,0,-35
5717,1,1,192,1207,1015
5718,0,0,23,0,-23
5719,1,0,3,0,-3
5720,0,0,104,0,-104
5721,0,0,61,0,-61
5722,1,0,17,0,-17
5723,1,0,6,0,-6
5724,1,1,529,1580,1051
5725,1,0,21,0,-21
5726,1,1,988,1510,522
5727,1,0,14,0,-14
5728,1,0,36,0,-36
5729,1,0,7,0,-7
5730,0,0,36,0,-36
5731,1,1,813,1207,394
5732,0,0,15,0,-15
5733,1,1,313,1808,1495
5734,1,1,767,2686,1919
5735,0,0,12,0,-12
5736,1,1,331,1394,1063
5737,1,1,261,1724,1463
5738,1,0,31,0,-31
5739,1,0,13,0,-13
5740,1,0,26,0,-26
5741,0,0,23,0,-23
5742,1,1,386,1275,889
5743,1,1,436,1774,1338
5744,1,0,15,0,-15
5745,1,1,56,1205,1149
5746,0,0,75,0,-75
5747,0,0,39,0,-39
5748,1,0,53,0,-53
5749,1,0,53,0,-53
5750,1,1,771,1454,683
5751,1,0,83,0,-83
5752,1,1,504,1246,742
5753,1,1,272,1307,1035
5754,0,0,35,0,-35
5755,1,0,43,0,-43
5756,1,0,98,0,-98
5757,0,0,6,0,-6
5758,1,1,143,1301,1158
5759,1,1,550,1462,912
5760,0,0,27,0,-27
5761,1,1,723,1213,490
5762,1,1,383,1800,1417
5763,1,0,25,0,-25
5764,0,0,3,0,-3
5765,1,0,28,0,-28
5766,0,0,99,0,-99
5767,1,1,391,1995,1604
5768,0,0,29,0,-29
5769,0,0,100,0,-100
5770,0,0,33,0,-33
5771,1,0,27,0,-27
5772,1,0,62,0,-62
5773,0,0,74,0,-74
5774,1,1,508,1636,1128
5775,0,0,50,0,-50
5776,1,0,80,0,-80
5777,1,1,617,1346,729
5778,0,0,58,0,-58
5779,1,1,463,1399,936
5780,1,1,439,2156,1717
5781,0,0,62,0,-62
5782,1,0,4,0,-4
5783,0,0,83,0,-83
5784,0,0,85,0,-85
5785,1,0,40,0,-40
5786,0,0,13,0,-13
5787,0,0,68,0,-68
5788,1,1,196,1732,1536
5789,1,0,18,0,-18
5790,1,0,90,0,-90
5791,1,1,1245,1623,378
5792,0,0,57,0,-57
5793,1,0,116,0,-116
5794,0,0,2,0,-2
5795,0,0,197,0,-197
5796,1,1,458,1328,870
5797,0,0,12,0,-12
5798,0,0,134,0,-134
5799,0,0,17,0,-17
5800,1,1,1089,2015,926
5801,1,1,52,1362,1310
5802,1,1,439,2917,2478
5803,1,0,14,0,-14
5804,1,0,135,0,-135
5805,0,0,39,0,-39
5806,0,0,57,0,-57
5807,0,0,159,0,-159
5808,0,0,36,0,-36
5809,0,0,15,0,-15
5810,1,0,37,0,-37
5811,0,0,21,0,-21
5812,1,1,230,1392,1162
5813,1,1,76,2271,2195
5814,1,1,698,2069,1371
5815,1,1,68,1954,1886
5816,1,0,20,0,-20
5817,0,0,97,0,-97
5818,1,1,84,1948,1864
5819,1,0,0,0,0
5820,1,1,607,2064,1457
5821,0,0,8,0,-8
5822,1,0,108,0,-108
5823,1,0,173,0,-173
5824,0,0,7,0,-7
5825,1,1,349,1722,1373
5826,1,1,92,1484,1392
5827,0,0,5,0,-5
5828,0,0,46,0,-46
5829,1,0,60,0,-60
5830,0,0,65,0,-65
5831,1,0,86,0,-86
5832,0,0,3,0,-3
5833,0,0,77,0,-77
5834,1,1,246,1226,980
5835,1,0,183,0,-183
5836,1,0,16,0,-16
5837,1,1,618,1416,798
5838,1,0,0,0,0
5839,0,0,29,0,-29
5840,1,1,1015,1590,575
5841,1,1,216,1570,1354
5842,1,1,488,1395,907
5843,1,1,1514,1616,102
5844,1,1,231,1606,1375
5845,0,0,54,0,-54
5846,1,0,158,0,-158
5847,1,1,133,1397,1264
5848,0,0,71,0,-71
5849,1,0,64,0,-64
5850,1,1,130,2124,1994
5851,0,0,12,0,-12
5852,1,1,41,1422,1381
5853,0,0,285,0,-285
5854,1,0,52,0,-52
5855,1,1,456,1445,989
5856,1,1,27,1475,1448
5857,0,0,111,0,-111
5858,1,0,17,0,-17
5859,1,0,13,0,-13
5860,0,0,16,0,-16
5861,1,1,118,1638,1520
5862,1,0,35,0,-35
5863,0,0,15,0,-15
5864,1,1,646,1563,917
5865,0,0,40,0,-40
5866,1,1,167,1289,1122
5867,0,0,42,0,-42
5868,1,0,114,0,-114
5869,0,0,44,0,-44
5870,1,0,81,0,-81
5871,0,0,132,0,-132
5872,1,0,29,0,-29
5873,0,0,18,0,-18
5874,0,0,22,0,-22
5875,0,0,33,0,-33
5876,0,0,102,0,-102
5877,1,1,86,1981,1895
5878,1,0,7,0,-7
5879,1,1,1478,1461,-17
5880,1,0,118,0,-118
5881,0,0,8,0,-8
5882,1,0,80,0,-80
5883,1,1,485,1222,737
5884,1,1,657,1422,765
5885,0,0,41,0,-41
5886,0,0,10,0,-10
5887,0,0,18,0,-18
5888,1,1,79,2174,2095
5889,1,1,391,1203,812
5890,1,1,1241,1295,54
5891,1,0,12,0,-12
5892,1,0,6,0,-6
5893,1,1,282,1404,1122
5894,0,0,22,0,-22
5895,1,0,14,0,-14
5896,1,0,34,0,-34
5897,0,0,47,0,-47
5898,0,0,37,0,-37
5899,1,0,18,0,-18
5900,0,0,2,0,-2
5901,1,0,36,0,-36
5902,1,0,17,0,-17
5903,0,0,98,0,-98
5904,1,1,587,1264,677
5905,1,1,192,1529,1337
5906,1,0,12,0,-12
5907,0,0,93,0,-93
5908,0,0,20,0,-20
5909,1,1,290,1357,1067
5910,1,0,151,0,-151
5911,0,0,24,0,-24
5912,1,0,3,0,-3
5913,1,1,663,1503,840
5914,0,0,131,0,-131
5915,1,0,88,0,-88
5916,1,0,96,0,-96
5917,0,0,1,0,-1
5918,1,0,65,0,-65
5919,1,0,51,0,-51
5920,1,0,26,0,-26
5921,1,0,54,0,-54
5922,1,1,845,1299,454
5923,1,0,25,0,-25
5924,1,0,33,0,-33
5925,0,0,8,0,-8
5926,1,0,12,0,-12
5927,1,0,3,0,-3
5928,1,0,82,0,-82
5929,1,1,63,1358,1295
5930,1,1,1373,1916,543
5931,1,1,233,2153,1920
5932,0,0,2,0,-2
5933,1,1,638,1563,925
5934,1,1,359,1805,1446
5935,0,0,98,0,-98
5936,0,0,129,0,-129
5937,0,0,13,0,-13
5938,1,1,771,3531,2760
5939,0,0,10,0,-10
5940,1,1,468,1588,1120
5941,0,0,41,0,-41
5942,1,1,283,1615,1332
5943,1,0,9,0,-9
5944,1,1,585,2968,2383
5945,0,0,73,0,-73
5946,0,0,38,0,-38
5947,0,0,69,0,-69
5948,1,1,852,1248,396
5949,0,0,72,0,-72
5950,1,0,12,0,-12
5951,1,1,151,2166,2015
5952,1,1,290,1325,1035
5953,0,0,13,0,-13
5954,1,1,137,1888,1751
5955,0,0,101,0,-101
5956,1,0,21,0,-21
5957,0,0,7,0,-7
5958,0,0,23,0,-23
5959,1,0,69,0,-69
5960,1,1,1254,1224,-30
5961,1,1,1693,3811,2118
5962,1,0,187,0,-187
5963,1,0,34,0,-34
5964,0,0,27,0,-27
5965,0,0,140,0,-140
5966,0,0,16,0,-16
5967,0,0,74,0,-74
5968,1,1,614,1253,639
5969,1,1,356,1661,1305
5970,1,0,78,0,-78
5971,1,1,375,1500,1125
5972,1,0,19,0,-19
5973,0,0,89,0,-89
5974,0,0,9,0,-9
5975,1,1,1311,1513,202
5976,1,1,265,1250,985
5977,1,1,359,1420,1061
5978,1,1,540,1802,1262
5979,1,0,104,0,-104
5980,0,0,32,0,-32
5981,0,0,106,0,-106
5982,1,0,95,0,-95
5983,1,0,13,0,-13
5984,0,0,9,0,-9
5985,0,0,34,0,-34
5986,0,0,6,0,-6
5987,1,1,378,1368,990
5988,0,0,3,0,-3
5989,1,0,7,0,-7
5990,0,0,2,0,-2
5991,0,0,5,0,-5
5992,0,0,91,0,-91
5993,1,0,5,0,-5
5994,0,0,24,0,-24
5995,0,0,5,0,-5
5996,1,1,713,1298,585
5997,0,0,49,0,-49
5998,1,0,0,0,0
5999,0,0,54,0,-54
6000,0,0,12,0,-12
6001,1,0,57,0,-57
6002,1,1,3378,1426,-1952
6003,1,0,1,0,-1
6004,0,0,21,0,-21
6005,1,1,38,1307,1269
6006,1,1,1016,3683,2667
6007,1,0,41,0,-41
6008,1,0,7,0,-7
6009,1,1,45,1516,1471
6010,0,0,24,0,-24
6011,1,1,584,1275,691
6012,1,0,8,0,-8
6013,1,1,144,1229,1085
6014,0,0,7,0,-7
6015,0,0,94,0,-94
6016,1,1,1283,1400,117
6017,1,1,826,1430,604
6018,0,0,10,0,-10
6019,1,0,72,0,-72
6020,1,0,47,0,-47
6021,0,0,96,0,-96
6022,1,0,0,0,0
6023,1,1,543,1611,1068
6024,1,0,42,0,-42
6025,1,0,44,0,-44
6026,0,0,1,0,-1
6027,1,0,12,0,-12
6028,0,0,5,0,-5
6029,0,0,216,0,-216
6030,0,0,21,0,-21
6031,0,0,50,0,-50
6032,1,1,646,1323,677
6033,1,1,615,1944,1329
6034,0,0,43,0,-43
6035,1,0,35,0,-35
6036,1,0,44,0,-44
6037,0,0,4,0,-4
6038,1,0,13,0,-13
6039,0,0,25,0,-25
6040,0,0,14,0,-14
6041,1,0,263,0,-263
6042,1,1,749,1211,462
6043,0,0,34,0,-34
6044,1,1,397,2470,2073
6045,1,0,14,0,-14
6046,0,0,32,0,-32
6047,1,0,164,0,-164
6048,1,0,69,0,-69
6049,1,0,50,0,-50
6050,1,0,135,0,-135
6051,1,1,1153,1281,128
6052,0,0,36,0,-36
6053,1,1,284,1515,1231
6054,1,1,91,1720,1629
6055,0,0,21,0,-21
6056,1,0,47,0,-47
6057,0,0,13,0,-13
6058,0,0,84,0,-84
6059,0,0,83,0,-83
6060,1,0,32,0,-32
6061,1,0,2,0,-2
6062,1,0,60,0,-60
6063,1,0,69,0,-69
6064,0,0,44,0,-44
6065,0,0,63,0,-63
6066,1,1,303,1536,1233
6067,0,0,5,0,-5
6068,1,1,672,1547,875
6069,1,0,15,0,-15
6070,1,0,75,0,-75
6071,0,0,2,0,-2
6072,1,1,891,1301,410
6073,0,0,14,0,-14
6074,0,0,180,0,-180
6075,1,1,156,1378,1222
6076,1,0,216,0,-216
6077,1,0,75,0,-75
6078,0,0,17,0,-17
6079,1,0,5,0,-5
6080,0,0,22,0,-22
6081,1,0,75,0,-75
6082,1,0,28,0,-28
6083,0,0,48,0,-48
6084,0,0,16,0,-16
6085,1,1,354,1752,1398
6086,0,0,5,0,-5
6087,1,1,1039,1261,222
6088,0,0,5,0,-5
6089,1,1,264,1887,1623
6090,0,0,71,0,-71
6091,1,1,2175,1395,-780
6092,1,0,25,0,-25
6093,1,1,548,1415,867
6094,1,0,25,0,-25
6095,1,0,32,0,-32
6096,1,0,53,0,-53
6097,1,1,410,1642,1232
6098,1,0,130,0,-130
6099,0,0,60,0,-60
6100,0,0,31,0,-31
6101,1,0,17,0,-17
6102,1,1,310,1240,930
6103,1,0,39,0,-39
6104,0,0,8,0,-8
6105,1,1,1108,2155,1047
6106,1,0,66,0,-66
6107,0,0,12,0,-12
6108,1,0,183,0,-183
6109,1,1,29,1637,1608
6110,1,1,325,1257,932
6111,0,0,18,0,-18
6112,1,1,1158,1310,152
6113,0,0,268,0,-268
6114,0,0,82,0,-82
6115,1,0,66,0,-66
6116,0,0,27,0,-27
6117,1,1,163,1651,1488
6118,0,0,14,0,-14
6119,0,0,5,0,-5
6120,0,0,13,0,-13
6121,1,0,7,0,-7
6122,1,1,1047,1215,168
6123,1,0,5,0,-5
6124,0,0,1,0,-1
6125,1,0,2,0,-2
6126,0,0,87,0,-87
6127,0,0,98,0,-98
6128,1,1,391,1249,858
6129,1,0,27,0,-27
6130,0,0,50,0,-50
6131,0,0,1,0,-1
6132,1,1,172,2430,2258
6133,1,0,0,0,0
6134,1,0,125,0,-125
6135,1,0,74,0,-74
6136,0,0,25,0,-25
6137,1,1,715,1578,863
6138,1,1,559,1328,769
6139,1,0,84,0,-84
6140,1,1,495,1395,900
6141,0,0,65,0,-65
6142,0,0,28,0,-28
6143,1,0,96,0,-96
6144,0,0,44,0,-44
6145,1,1,1508,1458,-50
6146,0,0,34,0,-34
6147,0,0,15,0,-15
6148,1,1,529,1273,744
6149,1,0,26,0,-26
6150,1,1,1038,1306,268
6151,1,1,162,1894,1732
6152,0,0,147,0,-147
6153,1,1,737,1393,656
6154,1,0,76,0,-76
6155,1,0,41,0,-41
6156,1,0,63,0,-63
6157,1,0,15,0,-15
6158,0,0,132,0,-132
6159,1,1,1630,1976,346
6160,0,0,13,0,-13
6161,0,0,7,0,-7
6162,1,0,137,0,-137
6163,0,0,174,0,-174
6164,1,1,37,1277,1240
6165,0,0,73,0,-73
6166,0,0,11,0,-11
6167,0,0,13,0,-13
6168,1,1,250,1483,1233
6169,1,0,1,0,-1
6170,0,0,65,0,-65
6171,1,1,748,1462,714
6172,1,1,675,1356,681
6173,1,1,115,1443,1328
6174,0,0,21,0,-21
6175,1,1,114,1251,1137
6176,1,1,930,1317,387
6177,0,0,288,0,-288
6178,0,0,116,0,-116
6179,0,0,54,0,-54
6180,1,1,238,1411,1173
6181,1,1,119,1273,1154
6182,1,0,44,0,-44
6183,1,1,1976,1226,-750
6184,1,1,310,1221,911
6185,1,1,627,2026,1399
6186,1,0,16,0,-16
6187,1,1,260,2437,2177
6188,0,0,1,0,-1
6189,0,0,54,0,-54
6190,0,0,32,0,-32
6191,1,1,154,1963,1809
6192,1,0,11,0,-11
6193,1,0,75,0,-75
6194,1,0,25,0,-25
6195,0,0,1,0,-1
6196,0,0,3,0,-3
6197,0,0,8,0,-8
6198,0,0,15,0,-15
6199,1,0,27,0,-27
6200,0,0,93,0,-93
6201,1,1,450,1212,762
6202,1,0,21,0,-21
6203,1,0,15,0,-15
6204,1,0,38,0,-38
6205,1,1,1292,1279,-13
6206,1,0,69,0,-69
6207,0,0,17,0,-17
6208,0,0,64,0,-64
6209,0,0,5,0,-5
6210,0,0,46,0,-46
6211,0,0,22,0,-22
6212,1,1,136,1456,1320
6213,1,1,1037,1242,205
6214,1,1,60,1586,1526
6215,1,1,518,3654,3136
6216,0,0,12,0,-12
6217,0,0,5,0,-5
6218,1,0,66,0,-66
6219,1,1,393,1220,827
6220,0,0,2,0,-2
6221,1,1,360,1696,1336
6222,0,0,41,0,-41
6223,0,0,5,0,-5
6224,1,0,101,0,-101
6225,0,0,39,0,-39
6226,0,0,153,0,-153
6227,1,1,370,1226,856
6228,1,0,33,0,-33
6229,1,0,56,0,-56
6230,1,1,547,1341,794
6231,1,1,166,1435,1269
6232,0,0,46,0,-46
6233,1,0,56,0,-56
6234,0,0,11,0,-11
6235,1,0,52,0,-52
6236,0,0,68,0,-68
6237,0,0,2,0,-2
6238,0,0,27,0,-27
6239,0,0,10,0,-10
6240,1,1,219,1423,1204
6241,1,0,109,0,-109
6242,1,0,140,0,-140
6243,1,0,44,0,-44
6244,1,0,5,0,-5
6245,0,0,84,0,-84
6246,0,0,30,0,-30
6247,1,1,112,1666,1554
6248,0,0,77,0,-77
6249,0,0,6,0,-6
6250,1,1,266,1275,1009
6251,0,0,2,0,-2
6252,0,0,2,0,-2
6253,0,0,6,0,-6
6254,0,0,28,0,-28
6255,0,0,194,0,-194
6256,1,0,60,0,-60
6257,0,0,33,0,-33
6258,1,0,23,0,-23
6259,0,0,3,0,-3
6260,0,0,51,0,-51
6261,1,0,46,0,-46
6262,0,0,5,0,-5
6263,1,0,49,0,-49
6264,0,0,48,0,-48
6265,1,0,16,0,-16
6266,0,0,37,0,-37
6267,1,0,31,0,-31
6268,0,0,35,0,-35
6269,1,0,56,0,-56
6270,1,1,832,1439,607
6271,0,0,120,0,-120
6272,0,0,161,0,-161
6273,1,1,97,1269,1172
6274,1,1,628,1201,573
6275,0,0,26,0,-26
6276,1,1,34,1734,1700
6277,0,0,53,0,-53
6278,0,0,19,0,-19
6279,1,0,16,0,-16
6280,0,0,80,0,-80
6281,1,1,728,1533,805
6282,1,1,962,1307,345
6283,1,0,8,0,-8
6284,1,0,2,0,-2
6285,1,1,181,1681,1500
6286,0,0,135,0,-135
6287,1,1,627,1368,741
6288,0,0,27,0,-27
6289,0,0,5,0,-5
6290,1,1,300,3854,3554
6291,0,0,59,0,-59
6292,0,0,10,0,-10
6293,1,0,50,0,-50
6294,1,1,582,1977,1395
6295,1,1,809,1404,595
6296,0,0,18,0,-18
6297,0,0,13,0,-13
6298,1,0,23,0,-23
6299,0,0,35,0,-35
6300,0,0,73,0,-73
6301,0,0,80,0,-80
6302,0,0,39,0,-39
6303,1,0,261,0,-261
6304,1,0,16,0,-16
6305,1,1,147,2199,2052
6306,0,0,67,0,-67
6307,0,0,81,0,-81
6308,1,0,46,0,-46
6309,1,0,55,0,-55
6310,1,1,1087,1212,125
6311,0,0,121,0,-121
6312,0,0,30,0,-30
6313,1,1,257,1207,950
6314,1,0,14,0,-14
6315,1,0,37,0,-37
6316,1,0,24,0,-24
6317,1,1,696,1880,1184
6318,1,1,714,1391,677
6319,1,0,37,0,-37
6320,1,1,366,1205,839
6321,0,0,123,0,-123
6322,0,0,4,0,-4
6323,0,0,80,0,-80
6324,1,1,534,1558,1024
6325,0,0,12,0,-12
6326,1,1,738,1503,765
6327,0,0,40,0,-40
6328,0,0,80,0,-80
6329,0,0,11,0,-11
6330,1,0,2,0,-2
6331,1,1,58,1250,1192
6332,1,0,31,0,-31
6333,1,1,560,1646,1086
6334,1,1,78,1294,1216
6335,1,0,219,0,-219
6336,1,0,56,0,-56
6337,0,0,1,0,-1
6338,1,0,65,0,-65
6339,1,0,27,0,-27
6340,1,0,72,0,-72
6341,0,0,13,0,-13
6342,1,1,488,1296,808
6343,0,0,199,0,-199
6344,1,0,3,0,-3
6345,1,1,288,1438,1150
6346,0,0,10,0,-10
6347,0,0,3,0,-3
6348,0,0,19,0,-19
6349,1,0,15,0,-15
6350,1,1,1153,1232,79
6351,0,0,0,0,0
6352,1,0,46,0,-46
6353,1,0,73,0,-73
6354,0,0,20,0,-20
6355,1,1,2025,1303,-722
6356,1,1,469,1598,1129
6357,1,0,76,0,-76
6358,0,0,9,0,-9
6359,1,0,11,0,-11
6360,1,1,64,1502,1438
6361,1,1,409,1202,793
6362,0,0,3,0,-3
6363,1,1,812,1267,455
6364,0,0,51,0,-51
6365,0,0,2,0,-2
6366,1,0,24,0,-24
6367,0,0,26,0,-26
6368,1,0,6,0,-6
6369,1,1,321,2773,2452
6370,1,0,40,0,-40
6371,0,0,23,0,-23
6372,1,0,82,0,-82
6373,1,0,26,0,-26
6374,1,0,28,0,-28
6375,1,1,1021,1260,239
6376,1,1,96,1479,1383
6377,0,0,12,0,-12
6378,1,1,335,1380,1045
6379,0,0,91,0,-91
6380,1,0,37,0,-37
6381,1,0,76,0,-76
6382,0,0,71,0,-71
6383,1,0,1,0,-1
6384,1,0,74,0,-74
6385,1,1,159,1755,1596
6386,1,1,171,1383,1212
6387,1,1,626,1378,752
6388,0,0,18,0,-18
6389,0,0,47,0,-47
6390,0,0,43,0,-43
6391,1,0,0,0,0
6392,1,1,132,1256,1124
6393,1,1,124,1622,1498
6394,1,0,42,0,-42
6395,0,0,89,0,-89
6396,1,0,17,0,-17
6397,1,1,406,1252,846
6398,0,0,26,0,-26
6399,1,0,25,0,-25
6400,0,0,8,0,-8
6401,1,1,994,1649,655
6402,0,0,13,0,-13
6403,0,0,52,0,-52
6404,0,0,9,0,-9
6405,1,0,62,0,-62
6406,1,1,1042,1375,333
6407,1,1,751,1417,666
6408,1,1,55,2143,2088
6409,0,0,13,0,-13
6410,0,0,82,0,-82
6411,0,0,37,0,-37
6412,1,1,168,1374,1206
6413,1,0,21,0,-21
6414,0,0,54,0,-54
6415,1,0,13,0,-13
6416,1,0,67,0,-67
6417,1,1,1154,2262,1108
6418,0,0,44,0,-44
6419,1,1,148,1467,1319
6420,0,0,21,0,-21
6421,0,0,284,0,-284
6422,1,1,1097,1377,280
6423,0,0,61,0,-61
6424,0,0,112,0,-112
6425,1,1,137,1270,1133
6426,1,1,409,1204,795
6427,1,1,257,1333,1076
