ID,Флаг дозвона,Флаг продажи,Расходы,PV,NPV
0,0,0,20,0,-20
1,0,0,12,0,-12
2,1,1,196,1424,1228
3,1,0,2,0,-2
4,1,0,78,0,-78
5,1,1,1986,1395,-591
6,1,0,70,0,-70
7,0,0,29,0,-29
8,0,0,3,0,-3
9,0,0,33,0,-33
10,0,0,7,0,-7
11,1,1,648,1293,645
12,0,0,73,0,-73
13,1,1,416,1393,977
14,0,0,8,0,-8
15,0,0,71,0,-71
16,1,0,10,0,-10
17,1,1,1207,1393,186
18,1,1,288,1790,1502
19,1,1,22,1279,1257
20,0,0,169,0,-169
21,0,0,5,0,-5
22,1,0,41,0,-41
23,1,1,725,1252,527
24,1,1,253,1414,1161
25,0,0,0,0,0
26,0,0,17,0,-17
27,1,0,7,0,-7
28,1,1,897,2085,1188
29,0,0,25,0,-25
30,1,0,13,0,-13
31,1,1,64,1550,1486
32,0,0,37,0,-37
33,1,0,7,0,-7
34,1,1,258,3220,2962
35,1,1,103,4845,4742
36,1,1,1185,1537,352
37,1,0,73,0,-73
38,0,0,17,0,-17
39,0,0,55,0,-55
40,0,0,4,0,-4
41,1,0,9,0,-9
42,1,1,215,1414,1199
43,0,0,91,0,-91
44,1,1,405,1664,1259
45,1,1,386,1741,1355
46,1,0,30,0,-30
47,1,1,827,1276,449
48,0,0,64,0,-64
49,1,1,69,1410,1341
50,1,1,373,1939,1566
51,1,1,281,1260,979
52,1,0,3,0,-3
53,0,0,146,0,-146
54,0,0,10,0,-10
55,0,0,27,0,-27
56,1,1,323,1323,1000
57,0,0,45,0,-45
58,0,0,68,0,-68
59,0,0,123,0,-123
60,0,0,50,0,-50
61,0,0,98,0,-98
62,0,0,40,0,-40
63,0,0,11,0,-11
64,0,0,68,0,-68
65,0,0,56,0,-56
66,1,1,238,1401,1163
67,1,0,121,0,-121
68,0,0,138,0,-138
69,1,1,464,1869,1405
70,1,0,147,0,-147
71,1,1,301,1259,958
72,0,0,11,0,-11
73,0,0,48,0,-48
74,0,0,4,0,-4
75,1,1,575,1374,799
76,1,0,60,0,-60
77,1,0,45,0,-45
78,0,0,5,0,-5
79,1,0,4,0,-4
80,0,0,21,0,-21
81,1,0,3,0,-3
82,1,0,20,0,-20
83,0,0,136,0,-136
84,1,0,6,0,-6
85,1,0,10,0,-10
86,1,1,42,1413,1371
87,0,0,3,0,-3
88,1,0,20,0,-20
89,0,0,4,0,-4
90,1,0,43,0,-43
91,1,0,26,0,-26
92,1,1,143,1487,1344
93,1,1,524,1692,1168
94,1,1,157,1419,1262
95,1,0,44,0,-44
96,1,0,4,0,-4
97,1,1,256,1269,1013
98,1,1,68,1256,1188
99,0,0,108,0,-108
100,1,0,45,0,-45
101,1,1,642,2111,1469
102,1,0,12,0,-12
103,0,0,33,0,-33
104,1,1,163,1735,1572
105,0,0,54,0,-54
106,0,0,23,0,-23
107,1,1,752,1277,525
108,0,0,17,0,-17
109,1,0,51,0,-51
110,1,0,12,0,-12
111,0,0,2,0,-2
112,1,0,67,0,-67
113,0,0,13,0,-13
114,0,0,70,0,-70
115,1,0,29,0,-29
116,1,0,62,0,-62
117,1,0,35,0,-35
118,1,1,191,1308,1117
119,1,1,2528,3394,866
120,0,0,22,0,-22
121,1,0,130,0,-130
122,1,1,483,1881,1398
123,1,1,52,1645,1593
124,0,0,5,0,-5
125,0,0,4,0,-4
126,1,0,86,0,-86
127,1,1,156,1266,1110
128,1,1,1457,1279,-178
129,0,0,100,0,-100
130,1,0,100,0,-100
131,1,1,110,2954,2844
132,1,0,10,0,-10
133,1,0,40,0,-40
134,0,0,47,0,-47
135,1,1,239,1497,1258
136,0,0,10,0,-10
137,1,0,2,0,-2
138,0,0,52,0,-52
139,1,1,304,1272,968
140,1,0,0,0,0
141,0,0,23,0,-23
142,1,1,368,1434,1066
143,1,0,93,0,-93
144,1,0,58,0,-58
145,0,0,4,0,-4
146,1,0,5,0,-5
147,1,0,29,0,-29
148,1,0,9,0,-9
149,1,1,638,1526,888
150,0,0,77,0,-77
151,1,1,62,1328,1266
152,0,0,19,0,-19
153,1,0,34,0,-34
154,0,0,78,0,-78
155,1,0,0,0,0
156,1,0,243,0,-243
157,0,0,160,0,-160
158,1,0,2,0,-2
159,0,0,3,0,-3
160,0,0,0,0,0
161,1,0,1,0,-1
162,1,0,22,0,-22
163,0,0,10,0,-10
164,1,0,66,0,-66
165,1,1,998,3561,2563
166,0,0,8,0,-8
167,0,0,9,0,-9
168,1,1,601,1396,795
169,1,0,49,0,-49
170,1,0,15,0,-15
171,1,1,972,1592,620
172,1,0,13,0,-13
173,0,0,17,0,-17
174,0,0,41,0,-41
175,0,0,175,0,-175
176,1,1,984,2690,1706
177,1,0,11,0,-11
178,0,0,19,0,-19
179,0,0,154,0,-154
180,1,0,21,0,-21
181,1,0,15,0,-15
182,1,1,739,1249,510
183,1,0,1,0,-1
184,1,1,627,1261,634
185,1,0,8,0,-8
186,1,1,87,1612,1525
187,1,1,461,1512,1051
188,1,1,559,1411,852
189,0,0,17,0,-17
190,0,0,103,0,-103
191,1,0,25,0,-25
192,1,0,23,0,-23
193,0,0,12,0,-12
194,0,0,43,0,-43
195,0,0,71,0,-71
196,1,0,8,0,-8
197,1,0,9,0,-9
198,1,0,112,0,-112
199,1,1,245,1354,1109
200,1,0,14,0,-14
201,1,0,51,0,-51
202,1,1,49,1280,1231
203,0,0,44,0,-44
204,1,0,10,0,-10
205,0,0,15,0,-15
206,1,1,105,1531,1426
207,0,0,69,0,-69
208,0,0,13,0,-13
209,1,0,191,0,-191
210,1,0,48,0,-48
211,1,0,17,0,-17
212,1,1,217,1451,1234
213,0,0,87,0,-87
214,0,0,66,0,-66
215,1,0,83,0,-83
216,0,0,44,0,-44
217,1,0,24,0,-24
218,1,0,55,0,-55
219,1,0,32,0,-32
220,0,0,102,0,-102
221,1,1,1708,1247,-461
222,1,1,532,1236,704
223,1,0,8,0,-8
224,0,0,168,0,-168
225,1,0,185,0,-185
226,1,0,98,0,-98
227,0,0,7,0,-7
228,1,1,842,1255,413
229,1,0,25,0,-25
230,0,0,41,0,-41
231,1,1,103,1411,1308
232,0,0,10,0,-10
233,1,0,38,0,-38
234,0,0,17,0,-17
235,0,0,5,0,-5
236,1,0,42,0,-42
237,0,0,49,0,-49
238,0,0,13,0,-13
239,1,0,19,0,-19
240,1,1,1060,1321,261
241,0,0,1,0,-1
242,0,0,35,0,-35
243,0,0,3,0,-3
244,1,0,6,0,-6
245,1,0,58,0,-58
246,1,1,1665,1491,-174
247,0,0,214,0,-214
248,1,1,302,1272,970
249,0,0,82,0,-82
250,1,0,7,0,-7
251,0,0,81,0,-81
252,1,1,481,1471,990
253,0,0,3,0,-3
254,1,1,185,1348,1163
255,1,0,41,0,-41
256,1,0,33,0,-33
257,1,1,531,1416,885
258,0,0,6,0,-6
259,0,0,3,0,-3
260,0,0,36,0,-36
261,1,0,1,0,-1
262,1,1,552,1825,1273
263,1,1,377,1721,1344
264,1,1,505,1909,1404
265,1,1,54,1260,1206
266,1,1,747,1262,515
267,1,1,967,1263,296
268,1,0,34,0,-34
269,0,0,47,0,-47
270,1,0,59,0,-59
271,1,0,14,0,-14
272,1,0,3,0,-3
273,1,1,88,1582,1494
274,0,0,30,0,-30
275,1,0,80,0,-80
276,1,1,66,1265,1199
277,1,1,187,3407,3220
278,1,1,277,1401,1124
279,1,1,373,1332,959
280,1,0,75,0,-75
281,0,0,12,0,-12
282,0,0,34,0,-34
283,0,0,109,0,-109
284,0,0,2,0,-2
285,1,0,7,0,-7
286,0,0,69,0,-69
287,1,0,37,0,-37
288,0,0,22,0,-22
289,1,0,1,0,-1
290,1,0,10,0,-10
291,1,1,244,1468,1224
292,0,0,3,0,-3
293,0,0,27,0,-27
294,0,0,1,0,-1
295,1,1,233,1693,1460
296,1,1,496,1349,853
297,0,0,24,0,-24
298,1,1,48,1238,1190
299,0,0,4,0,-4
300,1,1,349,1415,1066
301,0,0,42,0,-42
302,1,1,449,1313,864
303,1,0,41,0,-41
304,0,0,102,0,-102
305,1,0,76,0,-76
306,0,0,11,0,-11
307,1,0,23,0,-23
308,1,1,410,2054,1644
309,1,1,665,1775,1110
310,1,0,4,0,-4
311,1,0,47,0,-47
312,1,0,18,0,-18
313,0,0,23,0,-23
314,0,0,80,0,-80
315,1,1,708,1680,972
316,0,0,29,0,-29
317,1,1,761,1601,840
318,1,0,36,0,-36
319,1,1,121,1321,1200
320,1,0,39,0,-39
321,1,0,69,0,-69
322,0,0,64,0,-64
323,0,0,59,0,-59
324,1,1,440,2502,2062
325,1,1,368,1352,984
326,1,1,361,1715,1354
327,1,1,1267,1373,106
328,1,0,9,0,-9
329,0,0,42,0,-42
330,1,0,6,0,-6
331,0,0,14,0,-14
332,1,1,150,2003,1853
333,1,1,169,1670,1501
334,1,0,229,0,-229
335,0,0,21,0,-21
336,1,0,2,0,-2
337,0,0,44,0,-44
338,1,1,74,1871,1797
339,0,0,111,0,-111
340,0,0,54,0,-54
341,1,1,1217,1583,366
342,1,1,189,1542,1353
343,1,0,50,0,-50
344,0,0,19,0,-19
345,1,0,42,0,-42
346,0,0,19,0,-19
347,1,1,1106,1427,321
348,1,0,38,0,-38
349,1,0,16,0,-16
350,1,0,57,0,-57
351,1,0,0,0,0
352,1,0,23,0,-23
353,1,0,3,0,-3
354,1,0,36,0,-36
355,1,0,1,0,-1
356,1,0,46,0,-46
357,0,0,44,0,-44
358,0,0,85,0,-85
359,0,0,6,0,-6
360,0,0,2,0,-2
361,0,0,32,0,-32
362,0,0,27,0,-27
363,1,1,1175,1315,140
364,1,1,1694,1464,-230
365,0,0,131,0,-131
366,1,0,62,0,-62
367,0,0,27,0,-27
368,0,0,21,0,-21
369,1,1,417,1249,832
370,0,0,97,0,-97
371,0,0,24,0,-24
372,1,0,5,0,-5
373,1,0,2,0,-2
374,0,0,37,0,-37
375,0,0,3,0,-3
376,1,0,12,0,-12
377,0,0,0,0,0
378,0,0,19,0,-19
379,0,0,6,0,-6
380,1,1,166,1641,1475
381,1,1,443,1380,937
382,1,0,16,0,-16
383,0,0,78,0,-78
384,0,0,22,0,-22
385,1,0,8,0,-8
386,1,1,50,1589,1539
387,1,0,60,0,-60
388,0,0,25,0,-25
389,1,1,2309,1356,-953
390,0,0,91,0,-91
391,1,1,434,1277,843
392,1,1,337,1279,942
393,0,0,7,0,-7
394,0,0,23,0,-23
395,1,0,8,0,-8
396,0,0,36,0,-36
397,1,0,181,0,-181
398,1,0,86,0,-86
399,1,0,75,0,-75
400,1,1,1064,1876,812
401,1,0,25,0,-25
402,0,0,53,0,-53
403,1,0,22,0,-22
404,1,1,858,1485,627
405,1,1,215,1489,1274
406,0,0,12,0,-12
407,1,1,299,1345,1046
408,1,0,13,0,-13
409,0,0,7,0,-7
410,1,0,12,0,-12
411,1,1,519,2357,1838
412,0,0,2,0,-2
413,0,0,28,0,-28
414,1,0,39,0,-39
415,1,0,0,0,0
416,0,0,1,0,-1
417,1,0,205,0,-205
418,1,1,286,1882,1596
419,1,1,2954,1341,-1613
420,1,1,1364,1281,-83
421,1,1,596,2353,1757
422,1,1,780,1824,1044
423,1,0,50,0,-50
424,1,0,145,0,-145
425,0,0,0,0,0
426,1,1,3275,1321,-1954
427,1,0,1,0,-1
428,1,0,128,0,-128
429,0,0,69,0,-69
430,0,0,37,0,-37
431,1,1,785,1343,558
432,1,0,5,0,-5
433,0,0,100,0,-100
434,1,0,321,0,-321
435,1,0,2,0,-2
436,0,0,74,0,-74
437,1,1,629,1236,607
438,1,1,105,1276,1171
439,0,0,63,0,-63
440,0,0,194,0,-194
441,1,1,78,1400,1322
442,1,1,156,2100,1944
443,1,1,93,1871,1778
444,0,0,27,0,-27
445,0,0,185,0,-185
446,1,0,4,0,-4
447,0,0,25,0,-25
448,1,0,10,0,-10
449,1,0,3,0,-3
450,1,1,453,1318,865
451,1,1,403,1416,1013
452,0,0,23,0,-23
453,0,0,38,0,-38
454,0,0,70,0,-70
455,1,1,1095,1588,493
456,0,0,181,0,-181
457,0,0,163,0,-163
458,1,1,861,1939,1078
459,0,0,87,0,-87
460,1,1,864,2402,1538
461,0,0,15,0,-15
462,0,0,24,0,-24
463,1,1,320,1401,1081
464,1,0,20,0,-20
465,0,0,21,0,-21
466,0,0,75,0,-75
467,0,0,78,0,-78
468,1,0,207,0,-207
469,1,1,450,1326,876
470,1,1,168,1462,1294
471,1,0,25,0,-25
472,1,1,817,1444,627
473,0,0,13,0,-13
474,0,0,307,0,-307
475,0,0,25,0,-25
476,0,0,21,0,-21
477,1,0,20,0,-20
478,1,1,559,1692,1133
479,1,1,41,1635,1594
480,1,0,34,0,-34
481,1,0,11,0,-11
482,1,0,34,0,-34
483,1,0,26,0,-26
484,1,0,4,0,-4
485,0,0,70,0,-70
486,1,0,27,0,-27
487,1,0,16,0,-16
488,1,0,18,0,-18
489,1,1,291,1445,1154
490,0,0,2,0,-2
491,1,0,24,0,-24
492,1,1,510,1834,1324
493,1,1,182,2637,2455
494,1,0,88,0,-88
495,0,0,30,0,-30
496,1,0,39,0,-39
497,1,1,598,2279,1681
498,1,0,21,0,-21
499,0,0,10,0,-10
500,0,0,23,0,-23
501,0,0,36,0,-36
502,1,0,38,0,-38
503,1,0,61,0,-61
504,1,1,295,1401,1106
505,1,1,793,1358,565
506,1,1,316,1330,1014
507,1,1,232,1596,1364
508,1,0,62,0,-62
509,1,0,31,0,-31
510,0,0,71,0,-71
511,0,0,48,0,-48
512,1,1,1339,1726,387
513,0,0,31,0,-31
514,0,0,28,0,-28
515,0,0,77,0,-77
516,0,0,48,0,-48
517,0,0,61,0,-61
518,0,0,21,0,-21
519,0,0,95,0,-95
520,0,0,69,0,-69
521,1,0,78,0,-78
522,1,1,107,2533,2426
523,0,0,62,0,-62
524,1,0,17,0,-17
525,0,0,19,0,-19
526,0,0,6,0,-6
527,0,0,80,0,-80
528,0,0,34,0,-34
529,0,0,75,0,-75
530,1,0,90,0,-90
531,0,0,33,0,-33
532,0,0,21,0,-21
533,0,0,122,0,-122
534,0,0,73,0,-73
535,0,0,32,0,-32
536,1,0,6,0,-6
537,1,0,56,0,-56
538,0,0,101,0,-101
539,1,1,669,1503,834
540,1,0,2,0,-2
541,0,0,4,0,-4
542,0,0,96,0,-96
543,1,0,12,0,-12
544,0,0,0,0,0
545,0,0,30,0,-30
546,0,0,68,0,-68
547,0,0,17,0,-17
548,1,1,513,2345,1832
549,0,0,21,0,-21
550,1,0,104,0,-104
551,0,0,53,0,-53
552,1,0,9,0,-9
553,1,1,1180,2918,1738
554,1,0,50,0,-50
555,1,0,21,0,-21
556,1,1,890,1316,426
557,0,0,12,0,-12
558,1,0,11,0,-11
559,1,1,1455,1304,-151
560,1,1,552,1365,813
561,1,0,61,0,-61
562,1,0,20,0,-20
563,0,0,24,0,-24
564,1,1,747,1317,570
565,0,0,2,0,-2
566,1,0,112,0,-112
567,1,0,7,0,-7
568,1,0,156,0,-156
569,1,0,51,0,-51
570,0,0,68,0,-68
571,0,0,78,0,-78
572,0,0,6,0,-6
573,1,1,431,1741,1310
574,0,0,89,0,-89
575,1,0,56,0,-56
576,1,1,30,1617,1587
577,1,0,28,0,-28
578,0,0,42,0,-42
579,1,1,1053,1295,242
580,0,0,23,0,-23
581,1,1,158,1386,1228
582,1,0,14,0,-14
583,1,1,581,3587,3006
584,1,0,37,0,-37
585,1,1,772,1468,696
586,1,1,196,1470,1274
587,1,0,65,0,-65
588,0,0,6,0,-6
589,1,1,1312,1734,422
590,1,1,1046,1388,342
591,1,1,712,1600,888
592,0,0,3,0,-3
593,1,1,646,1785,1139
594,0,0,25,0,-25
595,0,0,26,0,-26
596,0,0,5,0,-5
597,0,0,65,0,-65
598,0,0,14,0,-14
599,1,0,78,0,-78
600,0,0,183,0,-183
601,1,1,185,1395,1210
602,1,0,84,0,-84
603,1,1,926,1564,638
604,1,1,33,1632,1599
605,0,0,48,0,-48
606,0,0,165,0,-165
607,1,1,1067,1778,711
608,0,0,27,0,-27
609,0,0,52,0,-52
610,1,1,179,1305,1126
611,1,0,5,0,-5
612,1,1,631,1256,625
613,0,0,20,0,-20
614,0,0,11,0,-11
615,1,0,37,0,-37
616,1,1,1093,1813,720
617,0,0,155,0,-155
618,0,0,75,0,-75
619,1,0,77,0,-77
620,0,0,3,0,-3
621,1,0,24,0,-24
622,1,1,22,1734,1712
623,1,0,78,0,-78
624,1,0,10,0,-10
625,1,1,784,2987,2203
626,0,0,32,0,-32
627,1,0,7,0,-7
628,0,0,4,0,-4
629,0,0,100,0,-100
630,1,0,41,0,-41
631,0,0,118,0,-118
632,1,0,12,0,-12
633,1,0,28,0,-28
634,0,0,92,0,-92
635,1,1,274,1696,1422
636,1,1,489,1873,1384
637,1,1,101,1490,1389
638,0,0,69,0,-69
639,0,0,175,0,-175
640,1,0,54,0,-54
641,0,0,35,0,-35
642,1,0,27,0,-27
643,1,0,105,0,-105
644,1,1,910,2717,1807
645,1,0,169,0,-169
646,1,1,118,1327,1209
647,0,0,4,0,-4
648,0,0,6,0,-6
649,1,1,254,2470,2216
650,1,0,6,0,-6
651,1,1,693,1247,554
652,1,0,39,0,-39
653,1,1,263,1368,1105
654,0,0,10,0,-10
655,1,1,401,1453,1052
656,1,0,6,0,-6
657,0,0,177,0,-177
658,0,0,42,0,-42
659,1,1,491,1345,854
660,1,1,423,1504,1081
661,0,0,50,0,-50
662,1,0,125,0,-125
663,1,0,59,0,-59
664,1,0,6,0,-6
665,0,0,20,0,-20
666,1,1,297,1323,1026
667,1,0,9,0,-9
668,1,0,124,0,-124
669,0,0,58,0,-58
670,0,0,53,0,-53
671,1,0,40,0,-40
672,0,0,8,0,-8
673,1,1,644,1333,689
674,1,0,51,0,-51
675,0,0,0,0,0
676,1,1,42,1781,1739
677,0,0,10,0,-10
678,0,0,217,0,-217
679,1,1,1861,1485,-376
680,1,1,857,1341,484
681,0,0,59,0,-59
682,0,0,41,0,-41
683,1,0,70,0,-70
684,1,0,10,0,-10
685,0,0,228,0,-228
686,0,0,87,0,-87
687,0,0,11,0,-11
688,0,0,20,0,-20
689,1,1,503,1378,875
690,0,0,38,0,-38
691,1,1,447,2157,1710
692,1,1,53,1247,1194
693,1,0,25,0,-25
694,0,0,4,0,-4
695,1,0,39,0,-39
696,1,0,55,0,-55
697,1,1,67,1344,1277
698,0,0,24,0,-24
699,0,0,37,0,-37
700,0,0,82,0,-82
701,1,1,212,1614,1402
702,1,0,2,0,-2
703,1,1,431,2562,2131
704,1,1,564,1468,904
705,1,1,379,3446,3067
706,1,0,3,0,-3
707,0,0,46,0,-46
708,1,1,324,1300,976
709,1,0,52,0,-52
710,0,0,5,0,-5
711,1,0,47,0,-47
712,0,0,4,0,-4
713,1,0,6,0,-6
714,1,1,524,1569,1045
715,0,0,29,0,-29
716,1,1,318,1854,1536
717,1,0,48,0,-48
718,0,0,27,0,-27
719,0,0,19,0,-19
720,0,0,1,0,-1
721,1,1,286,1782,1496
722,0,0,19,0,-19
723,0,0,119,0,-119
724,1,0,15,0,-15
725,1,0,39,0,-39
726,1,1,474,1372,898
727,1,1,443,1269,826
728,0,0,5,0,-5
729,0,0,26,0,-26
730,1,0,43,0,-43
731,1,1,143,1505,1362
732,1,1,322,1295,973
733,1,0,17,0,-17
734,1,1,291,2198,1907
735,1,1,488,1897,1409
736,1,1,2109,1235,-874
737,1,1,159,1466,1307
738,1,0,60,0,-60
739,1,0,24,0,-24
740,0,0,127,0,-127
741,1,0,2,0,-2
742,0,0,47,0,-47
743,0,0,33,0,-33
744,0,0,79,0,-79
745,1,1,335,1321,986
746,1,0,143,0,-143
747,0,0,45,0,-45
748,1,0,25,0,-25
749,1,0,71,0,-71
750,1,0,10,0,-10
751,1,1,72,2196,2124
752,0,0,13,0,-13
753,1,0,97,0,-97
754,1,1,660,1718,1058
755,0,0,48,0,-48
756,1,1,467,1591,1124
757,0,0,2,0,-2
758,1,1,637,1365,728
759,0,0,13,0,-13
760,1,0,50,0,-50
761,0,0,119,0,-119
762,1,1,286,1386,1100
763,1,0,138,0,-138
764,0,0,91,0,-91
765,1,1,590,1349,759
766,1,1,983,1383,400
767,0,0,15,0,-15
768,1,0,64,0,-64
769,0,0,12,0,-12
770,0,0,58,0,-58
771,0,0,1,0,-1
772,1,0,27,0,-27
773,1,1,302,1438,1136
774,0,0,5,0,-5
775,0,0,72,0,-72
776,0,0,58,0,-58
777,1,1,834,1405,571
778,1,0,48,0,-48
779,0,0,121,0,-121
780,0,0,20,0,-20
781,0,0,29,0,-29
782,1,1,690,1443,753
783,0,0,56,0,-56
784,0,0,74,0,-74
785,1,0,74,0,-74
786,0,0,17,0,-17
787,0,0,130,0,-130
788,1,0,133,0,-133
789,1,1,327,1619,1292
790,1,0,14,0,-14
791,1,0,98,0,-98
792,0,0,136,0,-136
793,0,0,17,0,-17
794,0,0,7,0,-7
795,1,0,38,0,-38
796,1,1,584,1381,797
797,1,1,877,1598,721
798,0,0,41,0,-41
799,0,0,25,0,-25
800,1,1,506,1350,844
801,0,0,144,0,-144
802,0,0,14,0,-14
803,1,1,456,1398,942
804,0,0,13,0,-13
805,1,0,23,0,-23
806,0,0,14,0,-14
807,0,0,86,0,-86
808,1,0,93,0,-93
809,0,0,12,0,-12
810,1,1,530,1985,1455
811,1,1,680,1268,588
812,0,0,24,0,-24
813,1,1,547,3681,3134
814,1,0,59,0,-59
815,1,1,87,1576,1489
816,1,1,296,1410,1114
817,1,1,394,1770,1376
818,1,0,18,0,-18
819,1,0,15,0,-15
820,0,0,2,0,-2
821,0,0,7,0,-7
822,0,0,86,0,-86
823,1,0,56,0,-56
824,1,1,403,1954,1551
825,0,0,238,0,-238
826,0,0,2,0,-2
827,0,0,32,0,-32
828,1,0,17,0,-17
829,1,0,12,0,-12
830,0,0,17,0,-17
831,0,0,127,0,-127
832,1,1,98,1482,1384
833,0,0,39,0,-39
834,1,0,46,0,-46
835,1,0,126,0,-126
836,0,0,0,0,0
837,1,0,11,0,-11
838,1,0,10,0,-10
839,1,0,134,0,-134
840,0,0,5,0,-5
841,1,0,8,0,-8
842,0,0,4,0,-4
843,1,1,378,1306,928
844,0,0,36,0,-36
845,0,0,8,0,-8
846,0,0,25,0,-25
847,1,0,17,0,-17
848,0,0,2,0,-2
849,1,0,8,0,-8
850,1,1,1194,1253,59
851,0,0,48,0,-48
852,0,0,41,0,-41
853,1,0,32,0,-32
854,0,0,74,0,-74
855,1,1,989,1330,341
856,0,0,50,0,-50
857,0,0,14,0,-14
858,1,0,8,0,-8
859,1,1,60,1247,1187
860,0,0,58,0,-58
861,0,0,21,0,-21
862,0,0,3,0,-3
863,0,0,0,0,0
864,1,0,14,0,-14
865,0,0,23,0,-23
866,0,0,46,0,-46
867,0,0,150,0,-150
868,1,0,80,0,-80
869,1,0,12,0,-12
870,1,0,11,0,-11
871,0,0,5,0,-5
872,1,1,157,1673,1516
873,1,1,468,1543,1075
874,0,0,145,0,-145
875,1,1,248,2089,1841
876,0,0,26,0,-26
877,0,0,255,0,-255
878,1,0,24,0,-24
879,0,0,5,0,-5
880,1,0,27,0,-27
881,0,0,285,0,-285
882,1,1,1062,1591,529
883,1,0,34,0,-34
884,0,0,18,0,-18
885,0,0,41,0,-41
886,0,0,29,0,-29
887,1,0,24,0,-24
888,0,0,6,0,-6
889,0,0,5,0,-5
890,0,0,0,0,0
891,0,0,29,0,-29
892,1,1,526,1246,720
893,0,0,23,0,-23
894,1,0,8,0,-8
895,0,0,49,0,-49
896,0,0,14,0,-14
897,1,0,28,0,-28
898,1,1,330,6065,5735
899,1,0,57,0,-57
900,0,0,61,0,-61
901,0,0,3,0,-3
902,0,0,86,0,-86
903,0,0,25,0,-25
904,0,0,49,0,-49
905,1,1,430,1622,1192
906,1,1,48,2151,2103
907,1,0,160,0,-160
908,0,0,94,0,-94
909,1,1,189,1556,1367
910,1,1,353,1318,965
911,1,0,21,0,-21
912,0,0,12,0,-12
913,1,1,74,1289,1215
914,0,0,27,0,-27
915,1,0,66,0,-66
916,1,1,196,1250,1054
917,1,1,166,1844,1678
918,1,0,79,0,-79
919,0,0,20,0,-20
920,0,0,58,0,-58
921,0,0,52,0,-52
922,0,0,4,0,-4
923,0,0,13,0,-13
924,0,0,47,0,-47
925,1,1,897,1344,447
926,0,0,36,0,-36
927,1,1,719,1241,522
928,1,1,118,1711,1593
929,1,1,952,1296,344
930,0,0,43,0,-43
931,1,0,2,0,-2
932,0,0,57,0,-57
933,0,0,0,0,0
934,1,0,4,0,-4
935,0,0,44,0,-44
936,1,1,54,1289,1235
937,1,0,3,0,-3
938,0,0,101,0,-101
939,1,0,34,0,-34
940,0,0,76,0,-76
941,0,0,4,0,-4
942,1,0,48,0,-48
943,0,0,70,0,-70
944,0,0,72,0,-72
945,1,1,681,1703,1022
946,0,0,9,0,-9
947,1,1,385,1267,882
948,1,0,21,0,-21
949,0,0,6,0,-6
950,0,0,8,0,-8
951,0,0,2,0,-2
952,1,1,371,1289,918
953,0,0,44,0,-44
954,1,1,970,1286,316
955,0,0,8,0,-8
956,0,0,13,0,-13
957,0,0,41,0,-41
958,0,0,277,0,-277
959,0,0,24,0,-24
960,1,0,20,0,-20
961,1,0,26,0,-26
962,1,1,463,1396,933
963,1,0,66,0,-66
964,1,1,654,1604,950
965,0,0,45,0,-45
966,1,1,497,1329,832
967,1,1,240,1739,1499
968,0,0,103,0,-103
969,1,0,86,0,-86
970,1,0,11,0,-11
971,0,0,22,0,-22
972,1,1,58,1279,1221
973,1,0,9,0,-9
974,1,1,78,1787,1709
975,0,0,57,0,-57
976,0,0,30,0,-30
977,0,0,10,0,-10
978,1,0,98,0,-98
979,1,0,38,0,-38
980,1,0,25,0,-25
981,0,0,83,0,-83
982,1,0,0,0,0
983,0,0,131,0,-131
984,0,0,13,0,-13
985,1,0,38,0,-38
986,1,1,428,1415,987
987,1,0,28,0,-28
988,1,0,2,0,-2
989,0,0,23,0,-23
990,1,0,15,0,-15
991,1,0,20,0,-20
992,0,0,0,0,0
993,0,0,11,0,-11
994,1,1,63,1639,1576
995,1,0,30,0,-30
996,0,0,2,0,-2
997,1,0,25,0,-25
998,1,0,174,0,-174
999,0,0,12,0,-12
1000,1,1,1109,1713,604
1001,0,0,50,0,-50
1002,1,1,105,1342,1237
1003,1,1,510,2103,1593
1004,0,0,50,0,-50
1005,1,1,31,2748,2717
1006,1,0,43,0,-43
1007,1,0,248,0,-248
1008,1,1,287,1270,983
1009,0,0,50,0,-50
1010,0,0,9,0,-9
1011,0,0,49,0,-49
1012,1,0,38,0,-38
1013,0,0,21,0,-21
1014,1,0,19,0,-19
1015,1,0,68,0,-68
1016,1,0,19,0,-19
1017,0,0,55,0,-55
1018,0,0,135,0,-135
1019,0,0,131,0,-131
1020,1,0,85,0,-85
1021,0,0,8,0,-8
1022,1,0,31,0,-31
1023,1,0,16,0,-16
1024,0,0,124,0,-124
1025,0,0,29,0,-29
1026,1,1,103,1270,1167
1027,1,0,136,0,-136
1028,1,0,2,0,-2
1029,1,0,7,0,-7
1030,1,0,329,0,-329
1031,1,0,11,0,-11
1032,1,1,603,1253,650
1033,1,1,62,2085,2023
1034,0,0,30,0,-30
1035,0,0,10,0,-10
1036,1,1,940,1370,430
1037,0,0,9,0,-9
1038,1,0,60,0,-60
1039,0,0,40,0,-40
1040,1,0,42,0,-42
1041,0,0,8,0,-8
1042,1,0,102,0,-102
1043,1,0,29,0,-29
1044,1,1,540,1630,1090
1045,0,0,5,0,-5
1046,1,0,21,0,-21
1047,0,0,213,0,-213
1048,1,0,77,0,-77
1049,0,0,58,0,-58
1050,1,0,59,0,-59
1051,1,0,34,0,-34
1052,1,0,71,0,-71
1053,1,0,61,0,-61
1054,0,0,2,0,-2
1055,0,0,6,0,-6
1056,0,0,134,0,-134
1057,1,0,0,0,0
1058,1,1,739,1438,699
1059,0,0,134,0,-134
1060,1,1,294,1274,980
1061,1,0,214,0,-214
1062,1,0,18,0,-18
1063,1,1,295,2988,2693
1064,1,1,17,1238,1221
1065,0,0,75,0,-75
1066,0,0,55,0,-55
1067,0,0,9,0,-9
1068,0,0,15,0,-15
1069,1,0,50,0,-50
1070,1,1,385,1593,1208
1071,0,0,61,0,-61
1072,1,1,291,1326,1035
1073,0,0,26,0,-26
1074,1,1,211,1516,1305
1075,1,1,235,2470,2235
1076,1,0,259,0,-259
1077,1,0,87,0,-87
1078,0,0,37,0,-37
1079,0,0,71,0,-71
1080,1,0,3,0,-3
1081,1,1,1306,1587,281
1082,0,0,43,0,-43
1083,0,0,25,0,-25
1084,1,1,766,2622,1856
1085,0,0,11,0,-11
1086,1,0,104,0,-104
1087,0,0,2,0,-2
1088,1,1,278,1441,1163
1089,1,1,414,1284,870
1090,1,0,21,0,-21
1091,0,0,46,0,-46
1092,0,0,2,0,-2
1093,0,0,36,0,-36
1094,1,1,532,1275,743
1095,1,1,250,1736,1486
1096,1,1,2044,1252,-792
1097,0,0,0,0,0
1098,0,0,47,0,-47
1099,1,0,7,0,-7
1100,0,0,4,0,-4
1101,0,0,1,0,-1
1102,0,0,20,0,-20
1103,0,0,9,0,-9
1104,1,1,138,1402,1264
1105,1,0,0,0,0
1106,1,1,754,1390,636
1107,1,1,143,1243,1100
1108,1,0,89,0,-89
1109,0,0,10,0,-10
1110,0,0,113,0,-113
1111,1,1,400,1279,879
1112,1,0,61,0,-61
1113,1,0,76,0,-76
1114,1,1,225,1253,1028
1115,1,1,920,2428,1508
1116,0,0,16,0,-16
1117,0,0,93,0,-93
1118,0,0,22,0,-22
1119,1,1,229,5065,4836
1120,1,0,155,0,-155
1121,1,0,49,0,-49
1122,1,1,163,1492,1329
1123,1,1,417,1734,1317
1124,0,0,162,0,-162
1125,0,0,152,0,-152
1126,0,0,3,0,-3
1127,1,0,81,0,-81
1128,0,0,38,0,-38
1129,0,0,17,0,-17
1130,1,0,1,0,-1
1131,1,0,58,0,-58
1132,0,0,50,0,-50
1133,1,1,315,1382,1067
1134,1,1,839,1268,429
1135,0,0,83,0,-83
1136,1,0,94,0,-94
1137,1,1,1353,2031,678
1138,1,0,78,0,-78
1139,0,0,275,0,-275
1140,1,0,16,0,-16
1141,1,0,33,0,-33
1142,0,0,66,0,-66
1143,0,0,79,0,-79
1144,1,0,19,0,-19
1145,0,0,38,0,-38
1146,1,0,45,0,-45
1147,1,1,601,1395,794
1148,0,0,17,0,-17
1149,1,1,692,1943,1251
1150,0,0,136,0,-136
1151,1,0,78,0,-78
1152,1,1,774,1537,763
1153,1,0,26,0,-26
1154,0,0,18,0,-18
1155,1,1,427,1340,913
1156,0,0,8,0,-8
1157,1,0,35,0,-35
1158,1,1,573,1307,734
1159,0,0,34,0,-34
1160,1,0,46,0,-46
1161,0,0,58,0,-58
1162,0,0,27,0,-27
1163,0,0,9,0,-9
1164,1,0,89,0,-89
1165,1,0,24,0,-24
1166,1,1,709,3449,2740
1167,1,1,141,1670,1529
1168,1,1,1612,2222,610
1169,1,1,1647,1242,-405
1170,1,1,2250,1244,-1006
1171,0,0,24,0,-24
1172,1,0,7,0,-7
1173,1,1,358,1506,1148
1174,1,1,2595,1236,-1359
1175,1,1,130,2227,2097
1176,1,0,44,0,-44
1177,0,0,77,0,-77
1178,0,0,8,0,-8
1179,1,0,14,0,-14
1180,0,0,14,0,-14
1181,1,1,51,1293,1242
1182,1,0,84,0,-84
1183,1,0,107,0,-107
1184,1,0,70,0,-70
1185,0,0,24,0,-24
1186,0,0,38,0,-38
1187,1,1,737,2064,1327
1188,1,0,45,0,-45
1189,0,0,68,0,-68
1190,1,0,77,0,-77
1191,0,0,11,0,-11
1192,0,0,125,0,-125
1193,1,1,559,2425,1866
1194,0,0,23,0,-23
1195,1,1,49,1416,1367
1196,1,1,287,1381,1094
1197,0,0,97,0,-97
1198,1,1,231,1635,1404
1199,1,0,30,0,-30
1200,1,0,141,0,-141
1201,1,1,466,1674,1208
1202,1,0,1,0,-1
1203,1,1,398,1466,1068
1204,1,1,501,1404,903
1205,1,1,1020,1806,786
1206,1,1,1359,4472,3113
1207,1,1,1051,1260,209
1208,0,0,30,0,-30
1209,0,0,22,0,-22
1210,0,0,7,0,-7
1211,1,0,118,0,-118
1212,0,0,45,0,-45
1213,1,0,5,0,-5
1214,1,1,309,1303,994
1215,1,1,180,1279,1099
1216,0,0,14,0,-14
1217,1,0,6,0,-6
1218,1,0,11,0,-11
1219,1,0,23,0,-23
1220,1,0,2,0,-2
1221,0,0,73,0,-73
1222,1,1,1720,1569,-151
1223,0,0,24,0,-24
1224,1,0,41,0,-41
1225,1,1,147,2284,2137
1226,1,1,803,1491,688
1227,1,0,60,0,-60
1228,0,0,48,0,-48
1229,0,0,46,0,-46
1230,0,0,31,0,-31
1231,0,0,50,0,-50
1232,0,0,64,0,-64
1233,0,0,37,0,-37
1234,1,1,421,1388,967
1235,1,1,224,1572,1348
1236,1,1,358,1362,1004
1237,1,1,1629,1468,-161
1238,1,0,132,0,-132
1239,1,0,151,0,-151
1240,0,0,17,0,-17
1241,0,0,235,0,-235
1242,0,0,58,0,-58
1243,0,0,70,0,-70
1244,1,1,423,1271,848
1245,1,1,1258,1275,17
1246,0,0,0,0,0
1247,1,1,203,1939,1736
1248,1,1,1574,2799,1225
1249,1,0,110,0,-110
1250,0,0,28,0,-28
1251,0,0,27,0,-27
1252,0,0,99,0,-99
1253,0,0,1,0,-1
1254,1,0,74,0,-74
1255,1,1,1056,1751,695
1256,1,0,138,0,-138
1257,0,0,33,0,-33
1258,1,1,1592,1236,-356
1259,0,0,90,0,-90
1260,0,0,6,0,-6
1261,0,0,95,0,-95
1262,0,0,18,0,-18
1263,1,1,169,1556,1387
1264,1,0,26,0,-26
1265,1,0,41,0,-41
1266,0,0,75,0,-75
1267,1,1,1146,1366,220
1268,1,1,437,1636,1199
1269,0,0,58,0,-58
1270,1,1,239,1472,1233
1271,0,0,14,0,-14
1272,1,0,24,0,-24
1273,1,0,53,0,-53
1274,1,1,158,1886,1728
1275,1,0,52,0,-52
1276,1,1,1026,1358,332
1277,0,0,41,0,-41
1278,0,0,71,0,-71
1279,1,0,26,0,-26
1280,1,1,345,1573,1228
1281,1,0,0,0,0
1282,0,0,86,0,-86
1283,1,1,927,2191,1264
1284,1,1,1308,1799,491
1285,1,0,96,0,-96
1286,0,0,29,0,-29
1287,0,0,28,0,-28
1288,0,0,28,0,-28
1289,1,0,41,0,-41
1290,1,0,24,0,-24
1291,1,0,25,0,-25
1292,0,0,114,0,-114
1293,1,0,130,0,-130
1294,0,0,42,0,-42
1295,0,0,80,0,-80
1296,0,0,33,0,-33
1297,0,0,46,0,-46
1298,1,0,48,0,-48
1299,1,1,580,4170,3590
1300,1,0,0,0,0
1301,1,0,424,0,-424
1302,1,0,30,0,-30
1303,1,1,170,1487,1317
1304,1,1,237,1415,1178
1305,1,1,36,1410,1374
1306,1,0,149,0,-149
1307,1,1,567,1337,770
1308,1,0,18,0,-18
1309,1,0,9,0,-9
1310,1,0,62,0,-62
1311,1,0,47,0,-47
1312,1,0,20,0,-20
1313,1,0,62,0,-62
1314,1,0,0,0,0
1315,1,0,34,0,-34
1316,1,1,786,1796,1010
1317,0,0,69,0,-69
1318,1,1,278,1306,1028
1319,1,0,3,0,-3
1320,1,0,74,0,-74
1321,0,0,21,0,-21
1322,0,0,19,0,-19
1323,1,1,73,1800,1727
1324,1,1,67,1949,1882
1325,1,1,616,1658,1042
1326,1,1,72,2496,2424
1327,1,0,14,0,-14
1328,1,1,168,1273,1105
1329,1,0,138,0,-138
1330,1,0,164,0,-164
1331,0,0,39,0,-39
1332,0,0,151,0,-151
1333,0,0,59,0,-59
1334,1,0,39,0,-39
1335,0,0,105,0,-105
1336,1,0,22,0,-22
1337,1,1,458,1593,1135
1338,0,0,22,0,-22
1339,0,0,35,0,-35
1340,0,0,37,0,-37
1341,1,0,15,0,-15
1342,1,1,124,2131,2007
1343,1,0,42,0,-42
1344,0,0,112,0,-112
1345,0,0,97,0,-97
1346,0,0,0,0,0
1347,0,0,8,0,-8
1348,1,1,59,1418,1359
1349,0,0,60,0,-60
1350,1,1,76,1285,1209
1351,0,0,40,0,-40
1352,1,1,2097,2257,160
1353,1,0,29,0,-29
1354,0,0,145,0,-145
1355,1,0,82,0,-82
1356,1,1,641,1571,930
1357,1,0,54,0,-54
1358,0,0,21,0,-21
1359,0,0,45,0,-45
1360,1,0,102,0,-102
1361,1,1,430,2526,2096
1362,0,0,29,0,-29
1363,0,0,17,0,-17
1364,1,0,65,0,-65
1365,0,0,92,0,-92
1366,1,0,0,0,0
1367,1,1,1160,1353,193
1368,1,1,228,3196,2968
1369,0,0,31,0,-31
1370,0,0,31,0,-31
1371,0,0,32,0,-32
1372,0,0,7,0,-7
1373,0,0,28,0,-28
1374,1,1,544,1323,779
1375,0,0,55,0,-55
1376,1,1,163,1854,1691
1377,1,1,1297,1462,165
1378,1,1,619,1297,678
1379,1,0,4,0,-4
1380,1,0,104,0,-104
1381,0,0,5,0,-5
1382,0,0,44,0,-44
1383,0,0,15,0,-15
1384,1,1,349,1714,1365
1385,1,0,17,0,-17
1386,1,1,1055,1358,303
1387,1,1,255,1833,1578
1388,1,1,584,1648,1064
1389,0,0,31,0,-31
1390,1,0,63,0,-63
1391,1,1,2155,1713,-442
1392,1,1,493,1798,1305
1393,0,0,24,0,-24
1394,1,1,410,1694,1284
1395,0,0,2,0,-2
1396,1,0,30,0,-30
1397,0,0,33,0,-33
1398,1,0,8,0,-8
1399,0,0,52,0,-52
1400,0,0,21,0,-21
1401,1,1,1298,1608,310
1402,0,0,26,0,-26
1403,1,0,109,0,-109
1404,0,0,61,0,-61
1405,1,0,7,0,-7
1406,1,1,790,1426,636
1407,1,1,107,1778,1671
1408,1,0,135,0,-135
1409,1,1,417,1274,857
1410,1,0,158,0,-158
1411,1,1,500,1967,1467
1412,1,1,589,1288,699
1413,0,0,17,0,-17
1414,0,0,86,0,-86
1415,0,0,13,0,-13
1416,0,0,0,0,0
1417,1,0,1,0,-1
1418,1,1,445,1570,1125
1419,0,0,25,0,-25
1420,0,0,45,0,-45
1421,1,0,25,0,-25
1422,0,0,3,0,-3
1423,1,1,514,1288,774
1424,1,1,168,1426,1258
1425,0,0,76,0,-76
1426,1,0,2,0,-2
1427,0,0,2,0,-2
1428,0,0,38,0,-38
1429,0,0,17,0,-17
1430,0,0,96,0,-96
1431,0,0,33,0,-33
1432,0,0,29,0,-29
1433,0,0,63,0,-63
1434,1,0,56,0,-56
1435,0,0,5,0,-5
1436,1,0,29,0,-29
1437,0,0,27,0,-27
1438,0,0,89,0,-89
1439,0,0,75,0,-75
1440,0,0,20,0,-20
1441,1,0,64,0,-64
1442,1,1,31,1255,1224
1443,0,0,22,0,-22
1444,1,0,4,0,-4
1445,0,0,32,0,-32
1446,1,1,205,2308,2103
1447,1,0,124,0,-124
1448,0,0,95,0,-95
1449,0,0,4,0,-4
1450,0,0,47,0,-47
1451,1,0,64,0,-64
1452,0,0,12,0,-12
1453,1,0,22,0,-22
1454,0,0,11,0,-11
1455,0,0,66,0,-66
1456,0,0,122,0,-122
1457,0,0,73,0,-73
1458,0,0,50,0,-50
1459,1,0,9,0,-9
1460,1,0,41,0,-41
1461,0,0,52,0,-52
1462,1,1,586,2074,1488
1463,1,1,1607,1264,-343
1464,0,0,23,0,-23
1465,0,0,39,0,-39
1466,1,0,8,0,-8
1467,1,0,15,0,-15
1468,1,1,433,1527,1094
1469,1,0,80,0,-80
1470,0,0,5,0,-5
1471,1,0,22,0,-22
1472,0,0,36,0,-36
1473,1,0,35,0,-35
1474,1,0,26,0,-26
1475,0,0,12,0,-12
1476,0,0,5,0,-5
1477,0,0,61,0,-61
1478,1,0,67,0,-67
1479,1,1,551,1269,718
1480,1,1,420,1282,862
1481,1,0,45,0,-45
1482,0,0,49,0,-49
1483,1,1,196,1846,1650
1484,1,0,80,0,-80
1485,1,0,94,0,-94
1486,0,0,115,0,-115
1487,0,0,12,0,-12
1488,0,0,86,0,-86
1489,0,0,0,0,0
1490,0,0,49,0,-49
1491,1,0,2,0,-2
1492,1,0,20,0,-20
1493,1,1,279,2407,2128
1494,1,0,0,0,0
1495,0,0,8,0,-8
1496,0,0,15,0,-15
1497,1,1,157,1302,1145
1498,1,1,445,1294,849
1499,1,1,630,1486,856
1500,0,0,22,0,-22
1501,0,0,253,0,-253
1502,1,0,13,0,-13
1503,1,1,718,1285,567
1504,1,1,228,1247,1019
1505,1,1,115,1690,1575
1506,0,0,4,0,-4
1507,0,0,18,0,-18
1508,0,0,2,0,-2
1509,1,0,14,0,-14
1510,0,0,23,0,-23
1511,1,1,677,2292,1615
1512,1,1,686,1448,762
1513,1,0,18,0,-18
1514,1,1,875,1269,394
1515,0,0,150,0,-150
1516,1,1,1189,1311,122
1517,1,1,655,2594,1939
1518,1,0,8,0,-8
1519,1,1,402,1317,915
1520,1,0,31,0,-31
1521,0,0,17,0,-17
1522,1,1,644,2049,1405
1523,1,0,18,0,-18
1524,0,0,106,0,-106
1525,1,1,152,4128,3976
1526,0,0,23,0,-23
1527,1,0,7,0,-7
1528,0,0,3,0,-3
1529,1,0,184,0,-184
1530,1,1,284,1300,1016
1531,1,0,3,0,-3
1532,0,0,55,0,-55
1533,0,0,49,0,-49
1534,1,0,2,0,-2
1535,1,1,333,1694,1361
1536,1,0,105,0,-105
1537,1,1,124,1519,1395
1538,0,0,3,0,-3
1539,1,1,364,1376,1012
1540,1,0,62,0,-62
1541,0,0,10,0,-10
1542,1,0,176,0,-176
1543,1,0,188,0,-188
1544,1,0,37,0,-37
1545,1,1,147,2111,1964
1546,1,1,1525,1320,-205
1547,0,0,44,0,-44
1548,1,1,988,1803,815
1549,1,1,149,1340,1191
1550,1,1,420,1538,1118
1551,0,0,21,0,-21
1552,0,0,58,0,-58
1553,1,1,154,1574,1420
1554,1,0,204,0,-204
1555,0,0,36,0,-36
1556,1,1,596,1392,796
1557,1,0,104,0,-104
1558,0,0,9,0,-9
1559,1,1,179,1729,1550
1560,1,0,45,0,-45
1561,1,0,36,0,-36
1562,1,0,6,0,-6
1563,1,1,852,1472,620
1564,0,0,35,0,-35
1565,1,1,48,1320,1272
1566,0,0,47,0,-47
1567,1,0,80,0,-80
1568,1,1,254,1656,1402
1569,1,1,60,3037,2977
1570,1,0,40,0,-40
1571,1,0,70,0,-70
1572,0,0,121,0,-121
1573,0,0,9,0,-9
1574,1,1,519,11141,10622
1575,1,0,21,0,-21
1576,0,0,132,0,-132
1577,1,1,21,1839,1818
1578,0,0,30,0,-30
1579,1,1,1027,1258,231
1580,0,0,52,0,-52
1581,0,0,48,0,-48
1582,0,0,96,0,-96
1583,0,0,84,0,-84
1584,0,0,116,0,-116
1585,1,0,24,0,-24
1586,1,0,111,0,-111
1587,0,0,4,0,-4
1588,1,0,31,0,-31
1589,1,1,936,1341,405
1590,1,1,633,1239,606
1591,0,0,192,0,-192
1592,1,0,0,0,0
1593,1,1,310,1420,1110
1594,0,0,8,0,-8
1595,1,0,4,0,-4
1596,1,0,24,0,-24
1597,1,0,0,0,0
1598,1,0,60,0,-60
1599,1,1,83,1238,1155
1600,1,0,63,0,-63
1601,0,0,0,0,0
1602,0,0,58,0,-58
1603,0,0,57,0,-57
1604,1,1,167,1617,1450
1605,1,0,4,0,-4
1606,1,0,28,0,-28
1607,1,1,1311,1801,490
1608,1,0,102,0,-102
1609,0,0,142,0,-142
1610,1,1,496,1441,945
1611,0,0,4,0,-4
1612,1,0,37,0,-37
1613,0,0,116,0,-116
1614,1,0,127,0,-127
1615,1,0,95,0,-95
1616,0,0,41,0,-41
1617,0,0,2,0,-2
1618,1,1,485,1439,954
1619,0,0,3,0,-3
1620,0,0,62,0,-62
1621,1,1,430,1758,1328
1622,1,0,35,0,-35
1623,0,0,75,0,-75
1624,1,0,8,0,-8
1625,0,0,9,0,-9
1626,0,0,16,0,-16
1627,0,0,12,0,-12
1628,0,0,129,0,-129
1629,1,0,7,0,-7
1630,1,1,346,1531,1185
1631,0,0,30,0,-30
1632,0,0,54,0,-54
1633,1,1,341,1254,913
1634,1,0,6,0,-6
1635,0,0,50,0,-50
1636,1,1,356,1295,939
1637,0,0,2,0,-2
1638,1,1,462,1322,860
1639,0,0,13,0,-13
1640,0,0,93,0,-93
1641,0,0,79,0,-79
1642,1,0,56,0,-56
1643,1,1,400,1948,1548
1644,0,0,45,0,-45
1645,1,0,15,0,-15
1646,1,1,191,1449,1258
1647,0,0,7,0,-7
1648,1,0,40,0,-40
1649,1,0,5,0,-5
1650,1,0,165,0,-165
1651,0,0,98,0,-98
1652,1,1,129,1418,1289
1653,1,1,296,1789,1493
1654,1,0,37,0,-37
1655,0,0,65,0,-65
1656,0,0,48,0,-48
1657,1,0,10,0,-10
1658,0,0,9,0,-9
1659,0,0,35,0,-35
1660,1,0,8,0,-8
1661,0,0,27,0,-27
1662,1,0,8,0,-8
1663,1,1,205,1385,1180
1664,0,0,18,0,-18
1665,1,0,15,0,-15
1666,1,1,814,1877,1063
1667,1,0,1,0,-1
1668,0,0,24,0,-24
1669,1,0,130,0,-130
1670,0,0,17,0,-17
1671,0,0,8,0,-8
1672,1,1,108,2085,1977
1673,0,0,2,0,-2
1674,0,0,53,0,-53
1675,1,0,100,0,-100
1676,1,0,50,0,-50
1677,0,0,45,0,-45
1678,1,1,1759,1261,-498
1679,1,0,180,0,-180
1680,1,0,14,0,-14
1681,1,0,2,0,-2
1682,0,0,5,0,-5
1683,1,1,908,1436,528
1684,0,0,62,0,-62
1685,1,1,83,1407,1324
1686,0,0,16,0,-16
1687,1,0,85,0,-85
1688,1,0,19,0,-19
1689,1,1,810,1411,601
1690,1,1,156,1599,1443
1691,0,0,12,0,-12
1692,1,1,140,1957,1817
1693,1,0,12,0,-12
1694,1,0,7,0,-7
1695,1,1,694,1557,863
1696,0,0,115,0,-115
1697,0,0,25,0,-25
1698,0,0,11,0,-11
1699,0,0,49,0,-49
1700,1,0,126,0,-126
1701,0,0,52,0,-52
1702,0,0,84,0,-84
1703,0,0,77,0,-77
1704,1,1,252,1273,1021
1705,0,0,18,0,-18
1706,1,0,0,0,0
1707,0,0,4,0,-4
1708,1,1,270,1274,1004
1709,1,0,29,0,-29
1710,1,1,479,1442,963
1711,0,0,234,0,-234
1712,0,0,0,0,0
1713,1,1,1115,1437,322
1714,1,1,153,1262,1109
1715,0,0,97,0,-97
1716,1,0,10,0,-10
1717,1,0,50,0,-50
1718,0,0,35,0,-35
1719,0,0,11,0,-11
1720,1,1,140,1366,1226
1721,0,0,20,0,-20
1722,0,0,3,0,-3
1723,0,0,3,0,-3
1724,1,0,16,0,-16
1725,1,1,171,1959,1788
1726,1,1,262,1350,1088
1727,1,0,85,0,-85
1728,0,0,54,0,-54
1729,1,0,87,0,-87
1730,1,0,192,0,-192
1731,0,0,50,0,-50
1732,1,1,1075,1945,870
1733,1,0,18,0,-18
1734,0,0,50,0,-50
1735,0,0,24,0,-24
1736,1,0,11,0,-11
1737,0,0,4,0,-4
1738,1,1,894,1239,345
1739,1,1,1755,1250,-505
1740,1,0,19,0,-19
1741,1,0,12,0,-12
1742,0,0,46,0,-46
1743,0,0,64,0,-64
1744,1,0,34,0,-34
1745,1,0,33,0,-33
1746,1,1,569,1380,811
1747,0,0,26,0,-26
1748,1,0,12,0,-12
1749,0,0,107,0,-107
1750,1,0,52,0,-52
1751,0,0,14,0,-14
1752,0,0,15,0,-15
1753,1,1,356,1351,995
1754,0,0,4,0,-4
1755,1,1,206,1236,1030
1756,0,0,29,0,-29
1757,1,1,817,2531,1714
1758,0,0,75,0,-75
1759,1,0,4,0,-4
1760,1,0,50,0,-50
1761,1,0,41,0,-41
1762,1,1,111,1430,1319
1763,0,0,18,0,-18
1764,1,1,142,1680,1538
1765,1,1,103,2335,2232
1766,1,0,7,0,-7
1767,0,0,4,0,-4
1768,0,0,95,0,-95
1769,1,0,55,0,-55
1770,1,1,359,1461,1102
1771,1,1,1201,1650,449
1772,0,0,101,0,-101
1773,0,0,168,0,-168
1774,0,0,31,0,-31
1775,1,0,66,0,-66
1776,0,0,16,0,-16
1777,0,0,38,0,-38
1778,1,0,24,0,-24
1779,1,0,0,0,0
1780,0,0,147,0,-147
1781,1,1,756,1345,589
1782,0,0,85,0,-85
1783,0,0,39,0,-39
1784,1,1,496,1420,924
1785,0,0,193,0,-193
1786,1,0,39,0,-39
1787,1,1,877,1263,386
1788,1,0,157,0,-157
1789,1,1,859,1466,607
1790,0,0,30,0,-30
1791,0,0,84,0,-84
1792,0,0,2,0,-2
1793,0,0,7,0,-7
1794,0,0,21,0,-21
1795,0,0,96,0,-96
1796,1,0,166,0,-166
1797,1,0,93,0,-93
1798,0,0,220,0,-220
1799,0,0,40,0,-40
1800,1,0,69,0,-69
1801,0,0,39,0,-39
1802,1,0,37,0,-37
1803,0,0,11,0,-11
1804,0,0,29,0,-29
1805,0,0,81,0,-81
1806,1,1,65,1636,1571
1807,0,0,10,0,-10
1808,0,0,49,0,-49
1809,0,0,4,0,-4
1810,1,1,219,1799,1580
1811,1,1,113,1987,1874
1812,1,0,16,0,-16
1813,1,0,36,0,-36
1814,1,1,189,1256,1067
1815,1,1,315,2277,1962
1816,0,0,29,0,-29
1817,1,1,856,1587,731
1818,1,1,128,1244,1116
1819,1,0,58,0,-58
1820,1,1,12,2765,2753
1821,0,0,14,0,-14
1822,1,0,23,0,-23
1823,0,0,13,0,-13
1824,1,0,11,0,-11
1825,1,0,46,0,-46
1826,1,0,42,0,-42
1827,1,0,1,0,-1
1828,0,0,21,0,-21
1829,0,0,14,0,-14
1830,1,0,68,0,-68
1831,1,0,11,0,-11
1832,1,1,558,1565,1007
1833,1,1,523,1354,831
1834,1,0,15,0,-15
1835,1,0,13,0,-13
1836,1,1,281,1483,1202
1837,1,0,29,0,-29
1838,0,0,83,0,-83
1839,0,0,30,0,-30
1840,1,1,424,1424,1000
1841,1,0,7,0,-7
1842,0,0,79,0,-79
1843,0,0,9,0,-9
1844,0,0,8,0,-8
1845,1,1,589,1322,733
1846,0,0,21,0,-21
1847,1,0,18,0,-18
1848,1,1,656,2155,1499
1849,1,0,156,0,-156
1850,1,1,1429,1872,443
1851,1,0,10,0,-10
1852,1,1,1256,1294,38
1853,0,0,12,0,-12
1854,1,1,503,1553,1050
1855,1,1,289,1399,1110
1856,1,0,42,0,-42
1857,0,0,55,0,-55
1858,0,0,15,0,-15
1859,1,0,31,0,-31
1860,1,0,2,0,-2
1861,0,0,30,0,-30
1862,1,1,111,1659,1548
1863,1,1,327,3233,2906
1864,1,0,3,0,-3
1865,0,0,22,0,-22
1866,0,0,74,0,-74
1867,1,0,161,0,-161
1868,1,1,333,1481,1148
1869,0,0,48,0,-48
1870,0,0,4,0,-4
1871,0,0,72,0,-72
1872,0,0,42,0,-42
1873,0,0,75,0,-75
1874,0,0,118,0,-118
1875,1,0,1,0,-1
1876,0,0,32,0,-32
1877,0,0,19,0,-19
1878,1,1,778,1402,624
1879,1,0,126,0,-126
1880,0,0,23,0,-23
1881,0,0,2,0,-2
1882,0,0,7,0,-7
1883,1,1,973,1511,538
1884,0,0,26,0,-26
1885,0,0,14,0,-14
1886,0,0,54,0,-54
1887,0,0,23,0,-23
1888,1,0,95,0,-95
1889,0,0,29,0,-29
1890,1,1,465,1750,1285
1891,1,0,32,0,-32
1892,1,1,210,1663,1453
1893,1,0,39,0,-39
1894,1,1,418,1349,931
1895,1,0,17,0,-17
1896,0,0,80,0,-80
1897,1,1,370,2171,1801
1898,1,1,1789,1316,-473
1899,1,0,28,0,-28
1900,0,0,21,0,-21
1901,1,1,50,1295,1245
1902,1,1,241,1276,1035
1903,1,0,83,0,-83
1904,1,0,25,0,-25
1905,1,0,15,0,-15
1906,0,0,182,0,-182
1907,1,0,18,0,-18
1908,1,1,254,3158,2904
1909,1,0,20,0,-20
1910,1,1,494,1368,874
1911,1,0,75,0,-75
1912,1,1,2491,1389,-1102
1913,0,0,122,0,-122
1914,1,1,174,1780,1606
1915,1,1,247,1425,1178
1916,1,1,451,1874,1423
1917,0,0,29,0,-29
1918,0,0,1,0,-1
1919,0,0,41,0,-41
1920,1,0,5,0,-5
1921,0,0,19,0,-19
1922,0,0,19,0,-19
1923,1,1,61,1448,1387
1924,1,1,117,1307,1190
1925,1,1,202,2023,1821
1926,1,0,222,0,-222
1927,0,0,21,0,-21
1928,0,0,15,0,-15
1929,1,0,127,0,-127
1930,1,0,54,0,-54
1931,0,0,9,0,-9
1932,1,0,78,0,-78
1933,1,1,862,1754,892
1934,1,0,99,0,-99
1935,0,0,8,0,-8
1936,0,0,6,0,-6
1937,1,1,974,1257,283
1938,0,0,25,0,-25
1939,1,0,31,0,-31
1940,0,0,68,0,-68
1941,1,1,447,1569,1122
1942,1,0,39,0,-39
1943,1,0,11,0,-11
1944,1,0,148,0,-148
1945,0,0,14,0,-14
1946,1,1,692,1458,766
1947,0,0,137,0,-137
1948,0,0,3,0,-3
1949,0,0,23,0,-23
1950,1,0,192,0,-192
1951,1,0,180,0,-180
1952,1,0,87,0,-87
1953,1,1,449,2644,2195
1954,1,0,46,0,-46
1955,1,1,386,1793,1407
1956,1,0,58,0,-58
1957,0,0,29,0,-29
1958,0,0,38,0,-38
1959,1,1,645,1239,594
1960,1,1,63,1421,1358
1961,1,1,321,1699,1378
1962,1,0,41,0,-41
1963,1,1,1958,1692,-266
1964,1,1,146,1464,1318
1965,1,1,691,1376,685
1966,1,0,181,0,-181
1967,0,0,15,0,-15
1968,1,0,68,0,-68
1969,1,0,16,0,-16
1970,0,0,65,0,-65
1971,1,0,42,0,-42
1972,1,0,12,0,-12
1973,1,1,94,1438,1344
1974,1,1,547,1539,992
1975,0,0,82,0,-82
1976,0,0,3,0,-3
1977,1,0,13,0,-13
1978,1,1,484,2050,1566
1979,0,0,51,0,-51
1980,1,0,36,0,-36
1981,1,1,1984,1787,-197
1982,1,0,55,0,-55
1983,1,1,820,1255,435
1984,1,0,56,0,-56
1985,1,0,46,0,-46
1986,1,1,813,1566,753
1987,1,0,67,0,-67
1988,0,0,180,0,-180
1989,1,1,202,2291,2089
1990,1,0,8,0,-8
1991,1,1,301,1645,1344
1992,1,0,41,0,-41
1993,0,0,68,0,-68
1994,0,0,61,0,-61
1995,1,1,320,1330,1010
1996,0,0,102,0,-102
1997,1,0,16,0,-16
1998,1,0,11,0,-11
1999,1,0,22,0,-22
2000,1,0,26,0,-26
2001,1,0,3,0,-3
2002,1,1,574,1687,1113
2003,0,0,26,0,-26
2004,1,1,431,1272,841
2005,1,0,15,0,-15
2006,1,0,8,0,-8
2007,1,1,186,1540,1354
2008,0,0,2,0,-2
2009,1,1,263,1586,1323
2010,0,0,15,0,-15
2011,1,1,76,4218,4142
2012,1,0,173,0,-173
2013,1,1,652,1767,1115
2014,0,0,93,0,-93
2015,0,0,57,0,-57
2016,1,0,49,0,-49
2017,0,0,11,0,-11
2018,1,0,8,0,-8
2019,1,0,177,0,-177
2020,1,1,157,2109,1952
2021,0,0,16,0,-16
2022,0,0,7,0,-7
2023,1,1,943,1324,381
2024,0,0,39,0,-39
2025,0,0,108,0,-108
2026,1,0,118,0,-118
2027,1,1,938,1432,494
2028,1,0,70,0,-70
2029,1,1,1034,1442,408
2030,1,1,276,1244,968
2031,0,0,240,0,-240
2032,1,0,149,0,-149
2033,0,0,0,0,0
2034,0,0,30,0,-30
2035,1,0,67,0,-67
2036,0,0,44,0,-44
2037,0,0,59,0,-59
2038,1,0,38,0,-38
2039,1,1,473,2329,1856
2040,1,1,900,1308,408
2041,1,0,17,0,-17
2042,1,0,68,0,-68
2043,1,1,127,1612,1485
2044,1,0,6,0,-6
2045,0,0,65,0,-65
2046,1,0,77,0,-77
2047,1,0,20,0,-20
2048,1,1,214,1270,1056
2049,0,0,21,0,-21
2050,1,1,504,1668,1164
2051,0,0,52,0,-52
2052,1,0,43,0,-43
2053,1,0,61,0,-61
2054,1,0,5,0,-5
2055,0,0,29,0,-29
2056,1,0,46,0,-46
2057,0,0,61,0,-61
2058,0,0,47,0,-47
2059,1,1,309,1295,986
2060,1,0,28,0,-28
2061,0,0,31,0,-31
2062,1,0,47,0,-47
2063,1,1,218,1468,1250
2064,1,0,27,0,-27
2065,1,0,4,0,-4
2066,0,0,27,0,-27
2067,0,0,7,0,-7
2068,0,0,187,0,-187
2069,0,0,40,0,-40
2070,1,1,471,1247,776
2071,0,0,51,0,-51
2072,1,1,151,2457,2306
2073,1,1,366,1542,1176
2074,1,1,214,1240,1026
2075,0,0,29,0,-29
2076,1,1,872,2069,1197
2077,1,0,42,0,-42
2078,1,1,338,1245,907
2079,1,0,11,0,-11
2080,1,1,275,1436,1161
2081,1,1,273,2457,2184
2082,0,0,73,0,-73
2083,0,0,43,0,-43
2084,1,0,49,0,-49
2085,0,0,27,0,-27
2086,0,0,24,0,-24
2087,1,0,30,0,-30
2088,1,1,664,1807,1143
2089,1,1,322,1469,1147
2090,1,1,384,1291,907
2091,1,1,77,2098,2021
2092,1,1,316,1333,1017
2093,1,0,78,0,-78
2094,1,1,500,1371,871
2095,1,1,1888,1299,-589
2096,1,1,133,1356,1223
2097,1,0,44,0,-44
2098,1,1,114,1526,1412
2099,1,1,440,3642,3202
2100,1,1,497,1313,816
2101,0,0,38,0,-38
2102,1,1,439,1487,1048
2103,1,0,4,0,-4
2104,1,0,85,0,-85
2105,0,0,150,0,-150
2106,0,0,104,0,-104
2107,1,0,97,0,-97
2108,1,0,16,0,-16
2109,0,0,28,0,-28
2110,0,0,129,0,-129
2111,1,0,42,0,-42
2112,0,0,163,0,-163
2113,1,0,19,0,-19
2114,1,0,54,0,-54
2115,1,0,9,0,-9
2116,0,0,160,0,-160
2117,0,0,47,0,-47
2118,0,0,26,0,-26
2119,0,0,60,0,-60
2120,0,0,335,0,-335
2121,1,1,300,1534,1234
2122,1,0,35,0,-35
2123,1,1,428,1580,1152
2124,1,0,104,0,-104
2125,1,1,772,1376,604
2126,1,1,483,1321,838
2127,1,1,1592,1677,85
2128,0,0,31,0,-31
2129,1,1,1168,1357,189
2130,1,0,27,0,-27
2131,1,0,46,0,-46
2132,1,1,343,2061,1718
2133,1,0,43,0,-43
2134,1,1,1254,1484,230
2135,0,0,73,0,-73
2136,1,0,84,0,-84
2137,1,1,1103,1311,208
2138,1,1,1528,2293,765
2139,1,1,425,1344,919
2140,1,0,17,0,-17
2141,0,0,23,0,-23
2142,0,0,53,0,-53
2143,0,0,6,0,-6
2144,1,1,43,1672,1629
2145,1,1,54,1387,1333
2146,1,1,400,1267,867
2147,0,0,40,0,-40
2148,0,0,138,0,-138
2149,0,0,52,0,-52
2150,1,0,182,0,-182
2151,0,0,17,0,-17
2152,1,0,45,0,-45
2153,1,0,53,0,-53
2154,0,0,8,0,-8
2155,0,0,64,0,-64
2156,0,0,6,0,-6
2157,1,1,247,1328,1081
2158,0,0,117,0,-117
2159,1,0,6,0,-6
2160,1,1,566,1546,980
2161,0,0,103,0,-103
2162,1,0,4,0,-4
2163,1,0,53,0,-53
2164,1,1,562,2185,1623
2165,1,0,39,0,-39
2166,1,1,84,1711,1627
2167,1,0,21,0,-21
2168,1,1,745,1314,569
2169,1,1,384,1249,865
2170,0,0,25,0,-25
2171,1,0,19,0,-19
2172,1,1,1566,1717,151
2173,1,1,57,1258,1201
2174,0,0,11,0,-11
2175,0,0,160,0,-160
2176,1,0,30,0,-30
2177,1,1,378,1845,1467
2178,1,0,51,0,-51
2179,1,0,29,0,-29
2180,1,1,72,1276,1204
2181,1,0,6,0,-6
2182,0,0,51,0,-51
2183,0,0,30,0,-30
2184,1,0,40,0,-40
2185,0,0,61,0,-61
2186,1,0,218,0,-218
2187,1,1,778,2310,1532
2188,1,1,166,1745,1579
2189,1,0,72,0,-72
2190,1,0,12,0,-12
2191,1,0,6,0,-6
2192,1,1,1464,1502,38
2193,1,0,74,0,-74
2194,1,0,66,0,-66
2195,1,0,131,0,-131
2196,1,0,23,0,-23
2197,0,0,66,0,-66
2198,0,0,15,0,-15
2199,1,1,348,1260,912
2200,0,0,84,0,-84
2201,1,0,57,0,-57
2202,1,0,52,0,-52
2203,1,0,11,0,-11
2204,0,0,1,0,-1
2205,0,0,9,0,-9
2206,1,0,58,0,-58
2207,1,1,586,1849,1263
2208,0,0,100,0,-100
2209,1,0,16,0,-16
2210,1,0,36,0,-36
2211,0,0,12,0,-12
2212,0,0,35,0,-35
2213,0,0,35,0,-35
2214,1,0,20,0,-20
2215,1,1,249,2133,1884
2216,1,1,1141,1955,814
2217,0,0,181,0,-181
2218,1,0,165,0,-165
2219,0,0,38,0,-38
2220,0,0,21,0,-21
2221,0,0,18,0,-18
2222,1,1,1600,1914,314
2223,0,0,25,0,-25
2224,1,0,6,0,-6
2225,0,0,53,0,-53
2226,1,0,56,0,-56
2227,0,0,32,0,-32
2228,1,1,53,1302,1249
2229,0,0,15,0,-15
2230,1,1,419,1279,860
2231,0,0,78,0,-78
2232,0,0,7,0,-7
2233,0,0,22,0,-22
2234,0,0,215,0,-215
2235,1,1,328,1448,1120
2236,1,0,118,0,-118
2237,1,1,339,1281,942
2238,1,0,12,0,-12
2239,1,1,463,1498,1035
2240,1,0,7,0,-7
2241,1,0,101,0,-101
2242,1,0,15,0,-15
2243,0,0,77,0,-77
2244,1,0,67,0,-67
2245,0,0,31,0,-31
2246,1,1,47,1260,1213
2247,0,0,14,0,-14
2248,1,1,1072,1378,306
2249,1,0,29,0,-29
2250,1,0,262,0,-262
2251,1,1,412,1422,1010
2252,1,0,180,0,-180
2253,1,1,250,1412,1162
2254,0,0,141,0,-141
2255,0,0,17,0,-17
2256,1,1,1614,1413,-201
2257,1,1,181,1301,1120
2258,0,0,6,0,-6
2259,1,0,3,0,-3
2260,1,1,1104,1815,711
2261,0,0,47,0,-47
2262,1,0,15,0,-15
2263,0,0,74,0,-74
2264,0,0,16,0,-16
2265,1,0,10,0,-10
2266,1,0,42,0,-42
2267,1,1,719,1482,763
2268,1,1,46,2041,1995
2269,1,1,852,1888,1036
2270,1,0,7,0,-7
2271,1,1,1545,1281,-264
2272,1,0,167,0,-167
2273,0,0,34,0,-34
2274,0,0,27,0,-27
2275,0,0,60,0,-60
2276,0,0,15,0,-15
2277,1,1,1782,1251,-531
2278,0,0,84,0,-84
2279,1,1,164,1268,1104
2280,1,0,151,0,-151
2281,0,0,65,0,-65
2282,1,0,41,0,-41
2283,1,1,377,1565,1188
2284,0,0,18,0,-18
2285,0,0,16,0,-16
2286,1,0,103,0,-103
2287,1,1,8,1238,1230
2288,1,1,100,1411,1311
2289,1,0,9,0,-9
2290,0,0,41,0,-41
2291,1,0,12,0,-12
2292,0,0,73,0,-73
2293,1,0,24,0,-24
2294,0,0,21,0,-21
2295,1,1,241,1276,1035
2296,0,0,77,0,-77
2297,1,0,31,0,-31
2298,0,0,47,0,-47
2299,1,0,28,0,-28
2300,1,0,71,0,-71
2301,1,1,273,1507,1234
2302,0,0,13,0,-13
2303,1,1,533,1245,712
2304,1,1,217,2621,2404
2305,0,0,20,0,-20
2306,1,0,21,0,-21
2307,0,0,63,0,-63
2308,1,0,15,0,-15
2309,1,1,576,1579,1003
2310,1,1,893,1359,466
2311,1,0,104,0,-104
2312,0,0,1,0,-1
2313,0,0,6,0,-6
2314,1,1,349,1883,1534
2315,1,0,17,0,-17
2316,1,1,51,2111,2060
2317,1,1,649,1595,946
2318,0,0,0,0,0
2319,1,1,61,1899,1838
2320,0,0,22,0,-22
2321,0,0,18,0,-18
2322,1,1,618,1982,1364
2323,1,0,4,0,-4
2324,0,0,1,0,-1
2325,1,1,188,1406,1218
2326,0,0,336,0,-336
2327,1,0,15,0,-15
2328,0,0,16,0,-16
2329,0,0,77,0,-77
2330,1,1,357,1725,1368
2331,1,1,80,1846,1766
2332,0,0,39,0,-39
2333,1,1,126,2216,2090
2334,1,0,109,0,-109
2335,1,1,2111,1488,-623
2336,0,0,13,0,-13
2337,0,0,15,0,-15
2338,1,1,421,1532,1111
2339,0,0,319,0,-319
2340,1,1,841,2367,1526
2341,1,1,355,2078,1723
2342,1,0,20,0,-20
2343,1,1,97,1391,1294
2344,1,1,174,3436,3262
2345,1,1,118,1424,1306
2346,1,0,19,0,-19
2347,0,0,6,0,-6
2348,1,0,121,0,-121
2349,1,0,37,0,-37
2350,0,0,20,0,-20
2351,0,0,43,0,-43
2352,1,0,33,0,-33
2353,1,0,0,0,0
2354,0,0,39,0,-39
2355,0,0,39,0,-39
2356,1,0,22,0,-22
2357,1,0,23,0,-23
2358,0,0,68,0,-68
2359,1,1,2004,1287,-717
2360,0,0,30,0,-30
2361,1,1,469,1425,956
2362,0,0,28,0,-28
2363,0,0,3,0,-3
2364,0,0,6,0,-6
2365,0,0,48,0,-48
2366,1,1,1311,1315,4
2367,0,0,102,0,-102
2368,1,1,45,1737,1692
2369,1,0,23,0,-23
2370,1,1,302,1562,1260
2371,1,0,3,0,-3
2372,1,0,0,0,0
2373,1,0,69,0,-69
2374,0,0,30,0,-30
2375,1,0,62,0,-62
2376,1,1,815,1775,960
2377,0,0,36,0,-36
2378,0,0,49,0,-49
2379,0,0,21,0,-21
2380,0,0,41,0,-41
2381,0,0,84,0,-84
2382,0,0,55,0,-55
2383,1,0,36,0,-36
2384,0,0,3,0,-3
2385,0,0,0,0,0
2386,1,0,78,0,-78
2387,0,0,70,0,-70
2388,1,0,57,0,-57
2389,1,0,119,0,-119
2390,1,0,9,0,-9
2391,1,0,34,0,-34
2392,0,0,4,0,-4
2393,0,0,16,0,-16
2394,0,0,108,0,-108
2395,1,0,55,0,-55
2396,1,1,232,1389,1157
2397,1,1,618,1256,638
2398,0,0,31,0,-31
2399,1,1,456,1385,929
2400,0,0,60,0,-60
2401,0,0,44,0,-44
2402,0,0,4,0,-4
2403,0,0,26,0,-26
2404,0,0,75,0,-75
2405,1,0,50,0,-50
2406,1,1,86,2014,1928
2407,1,0,55,0,-55
2408,1,1,151,1707,1556
2409,1,1,355,1524,1169
2410,1,0,108,0,-108
2411,1,0,36,0,-36
2412,1,0,85,0,-85
2413,1,1,27,1247,1220
2414,0,0,54,0,-54
2415,1,0,2,0,-2
2416,0,0,38,0,-38
2417,1,1,1114,1851,737
2418,0,0,99,0,-99
2419,0,0,39,0,-39
2420,0,0,29,0,-29
2421,0,0,39,0,-39
2422,1,1,132,1279,1147
2423,1,0,80,0,-80
2424,1,1,176,1280,1104
2425,1,0,53,0,-53
2426,1,1,258,1963,1705
2427,1,0,23,0,-23
2428,1,0,28,0,-28
2429,1,1,502,1355,853
2430,1,1,104,1332,1228
2431,0,0,1,0,-1
2432,0,0,116,0,-116
2433,0,0,26,0,-26
2434,1,0,51,0,-51
2435,0,0,46,0,-46
2436,0,0,103,0,-103
2437,0,0,0,0,0
2438,1,0,63,0,-63
2439,0,0,11,0,-11
2440,1,0,22,0,-22
2441,1,1,245,2562,2317
2442,0,0,46,0,-46
2443,0,0,77,0,-77
2444,1,1,213,2095,1882
2445,0,0,37,0,-37
2446,1,1,438,2000,1562
2447,0,0,60,0,-60
2448,1,1,760,1869,1109
2449,0,0,8,0,-8
2450,0,0,17,0,-17
2451,1,1,178,1348,1170
2452,0,0,24,0,-24
2453,1,0,70,0,-70
2454,0,0,19,0,-19
2455,1,1,1941,1496,-445
2456,1,0,5,0,-5
2457,0,0,54,0,-54
2458,0,0,8,0,-8
2459,0,0,11,0,-11
2460,1,1,278,1327,1049
2461,0,0,4,0,-4
2462,0,0,80,0,-80
2463,1,0,24,0,-24
2464,1,0,8,0,-8
2465,1,0,35,0,-35
2466,0,0,12,0,-12
2467,1,0,3,0,-3
2468,0,0,8,0,-8
2469,1,1,81,1847,1766
2470,0,0,44,0,-44
2471,0,0,25,0,-25
2472,1,1,485,1350,865
2473,1,1,565,6245,5680
2474,1,0,48,0,-48
2475,0,0,26,0,-26
2476,0,0,11,0,-11
2477,1,1,6,1319,1313
2478,1,1,129,1727,1598
2479,0,0,4,0,-4
2480,1,1,635,1631,996
2481,1,1,228,2845,2617
2482,1,1,2325,1331,-994
2483,0,0,7,0,-7
2484,0,0,56,0,-56
2485,0,0,22,0,-22
2486,1,1,316,1843,1527
2487,1,0,23,0,-23
2488,1,1,86,2033,1947
2489,1,1,582,4379,3797
2490,1,1,400,1739,1339
2491,1,0,117,0,-117
2492,1,0,43,0,-43
2493,0,0,42,0,-42
2494,0,0,18,0,-18
2495,1,0,7,0,-7
2496,1,0,9,0,-9
2497,0,0,18,0,-18
2498,1,1,361,1759,1398
2499,1,1,367,1306,939
2500,1,1,135,2731,2596
2501,1,0,46,0,-46
2502,0,0,28,0,-28
2503,1,0,123,0,-123
2504,0,0,162,0,-162
2505,0,0,5,0,-5
2506,1,1,2283,1507,-776
2507,1,0,60,0,-60
2508,0,0,1,0,-1
2509,1,1,423,1505,1082
2510,1,0,139,0,-139
2511,0,0,79,0,-79
2512,0,0,42,0,-42
2513,1,1,293,1281,988
2514,0,0,2,0,-2
2515,0,0,5,0,-5
2516,0,0,20,0,-20
2517,1,1,1373,1438,65
2518,0,0,37,0,-37
2519,0,0,10,0,-10
2520,0,0,7,0,-7
2521,0,0,84,0,-84
2522,1,0,38,0,-38
2523,1,0,42,0,-42
2524,1,1,177,1336,1159
2525,1,1,85,1246,1161
2526,0,0,47,0,-47
2527,0,0,3,0,-3
2528,1,0,59,0,-59
2529,1,0,15,0,-15
2530,1,0,26,0,-26
2531,0,0,179,0,-179
2532,0,0,107,0,-107
2533,0,0,9,0,-9
2534,1,1,629,1236,607
2535,1,0,2,0,-2
2536,1,0,8,0,-8
2537,0,0,41,0,-41
2538,0,0,49,0,-49
2539,1,1,158,2212,2054
2540,1,1,299,1898,1599
2541,0,0,23,0,-23
2542,1,0,3,0,-3
2543,0,0,246,0,-246
2544,0,0,34,0,-34
2545,0,0,21,0,-21
2546,0,0,58,0,-58
2547,1,1,2456,1536,-920
2548,1,0,46,0,-46
2549,1,1,193,1378,1185
2550,1,0,3,0,-3
2551,1,1,252,1442,1190
2552,1,1,172,2473,2301
2553,1,0,27,0,-27
2554,0,0,81,0,-81
2555,0,0,33,0,-33
2556,1,0,55,0,-55
2557,0,0,10,0,-10
2558,0,0,75,0,-75
2559,1,0,62,0,-62
2560,1,1,187,2176,1989
2561,0,0,36,0,-36
2562,0,0,25,0,-25
2563,1,1,94,1336,1242
2564,1,1,178,1517,1339
2565,1,0,40,0,-40
2566,1,0,39,0,-39
2567,0,0,101,0,-101
2568,0,0,34,0,-34
2569,1,1,574,1691,1117
2570,1,1,1212,1303,91
2571,0,0,99,0,-99
2572,1,1,169,2039,1870
2573,1,1,588,2419,1831
2574,1,0,19,0,-19
2575,0,0,49,0,-49
2576,0,0,65,0,-65
2577,1,0,73,0,-73
2578,1,0,113,0,-113
2579,0,0,113,0,-113
2580,1,0,26,0,-26
2581,1,0,17,0,-17
2582,1,1,1557,3398,1841
2583,1,0,1,0,-1
2584,0,0,46,0,-46
2585,0,0,6,0,-6
2586,1,0,9,0,-9
2587,0,0,81,0,-81
2588,0,0,30,0,-30
2589,1,0,57,0,-57
2590,0,0,64,0,-64
2591,0,0,23,0,-23
2592,1,1,222,1250,1028
2593,1,0,4,0,-4
2594,1,1,11,2259,2248
2595,1,1,324,2032,1708
2596,0,0,64,0,-64
2597,1,0,58,0,-58
2598,1,1,544,1582,1038
2599,1,1,69,1541,1472
2600,1,0,9,0,-9
2601,1,0,100,0,-100
2602,1,0,50,0,-50
2603,1,1,920,1344,424
2604,1,1,695,1415,720
2605,1,1,144,3176,3032
2606,0,0,17,0,-17
2607,1,0,8,0,-8
2608,1,0,42,0,-42
2609,1,1,530,1272,742
2610,0,0,10,0,-10
2611,1,0,44,0,-44
2612,0,0,71,0,-71
2613,1,1,1605,1364,-241
2614,1,1,865,1248,383
2615,0,0,41,0,-41
2616,0,0,43,0,-43
2617,1,0,4,0,-4
2618,0,0,51,0,-51
2619,1,0,47,0,-47
2620,0,0,27,0,-27
2621,1,0,4,0,-4
2622,1,0,119,0,-119
2623,1,1,35,6480,6445
2624,0,0,3,0,-3
2625,1,1,412,1242,830
2626,1,1,172,2213,2041
2627,0,0,19,0,-19
2628,1,1,327,1710,1383
2629,1,1,99,1675,1576
2630,0,0,8,0,-8
2631,0,0,57,0,-57
2632,0,0,17,0,-17
2633,1,1,778,1235,457
2634,0,0,0,0,0
2635,1,1,384,1246,862
2636,1,0,33,0,-33
2637,1,1,959,1444,485
2638,1,1,648,1835,1187
2639,1,0,144,0,-144
2640,1,0,19,0,-19
2641,0,0,75,0,-75
2642,0,0,30,0,-30
2643,1,1,1799,1429,-370
2644,1,1,859,1387,528
2645,0,0,0,0,0
2646,1,1,62,1294,1232
2647,1,0,2,0,-2
2648,1,0,118,0,-118
2649,0,0,209,0,-209
2650,1,0,21,0,-21
2651,1,1,578,1400,822
2652,0,0,30,0,-30
2653,1,0,13,0,-13
2654,0,0,33,0,-33
2655,1,1,341,1301,960
2656,0,0,91,0,-91
2657,1,0,73,0,-73
2658,1,0,34,0,-34
2659,0,0,21,0,-21
2660,1,1,444,1513,1069
2661,1,1,106,1322,1216
2662,0,0,6,0,-6
2663,0,0,25,0,-25
2664,1,1,983,1376,393
2665,0,0,55,0,-55
2666,1,0,117,0,-117
2667,1,0,15,0,-15
2668,0,0,2,0,-2
2669,0,0,10,0,-10
2670,1,0,59,0,-59
2671,1,1,679,1420,741
2672,1,0,26,0,-26
2673,1,0,169,0,-169
2674,1,1,155,1559,1404
2675,1,0,12,0,-12
2676,1,0,72,0,-72
2677,0,0,33,0,-33
2678,1,0,133,0,-133
2679,1,0,78,0,-78
2680,0,0,23,0,-23
2681,0,0,7,0,-7
2682,1,0,14,0,-14
2683,0,0,2,0,-2
2684,1,1,1238,1513,275
2685,1,0,16,0,-16
2686,1,0,11,0,-11
2687,1,0,13,0,-13
2688,0,0,4,0,-4
2689,1,0,94,0,-94
2690,1,0,16,0,-16
2691,1,0,12,0,-12
2692,1,0,11,0,-11
2693,0,0,48,0,-48
2694,1,0,68,0,-68
2695,1,1,1025,1256,231
2696,1,0,19,0,-19
2697,1,1,860,1270,410
2698,1,1,74,1447,1373
2699,0,0,5,0,-5
2700,1,0,48,0,-48
2701,0,0,42,0,-42
2702,0,0,52,0,-52
2703,1,0,62,0,-62
2704,0,0,133,0,-133
2705,0,0,73,0,-73
2706,1,0,55,0,-55
2707,0,0,7,0,-7
2708,1,1,779,1265,486
2709,1,1,1661,1436,-225
2710,1,0,120,0,-120
2711,1,1,1082,1291,209
2712,1,1,19,1390,1371
2713,1,1,342,1343,1001
2714,1,0,66,0,-66
2715,1,1,703,1471,768
2716,1,1,981,1589,608
2717,0,0,1,0,-1
2718,1,1,411,1383,972
2719,1,0,26,0,-26
2720,0,0,13,0,-13
2721,1,1,32,1291,1259
2722,1,0,129,0,-129
2723,0,0,35,0,-35
2724,0,0,31,0,-31
2725,1,0,41,0,-41
2726,0,0,358,0,-358
2727,0,0,40,0,-40
2728,0,0,7,0,-7
2729,1,0,41,0,-41
2730,0,0,4,0,-4
2731,0,0,25,0,-25
2732,1,1,111,1462,1351
2733,0,0,133,0,-133
2734,0,0,52,0,-52
2735,0,0,40,0,-40
2736,0,0,17,0,-17
2737,0,0,16,0,-16
2738,1,1,468,1239,771
2739,1,1,80,2620,2540
2740,1,1,278,1737,1459
2741,1,0,78,0,-78
2742,1,0,29,0,-29
2743,1,1,51,2414,2363
2744,1,1,70,2084,2014
2745,1,1,1086,1832,746
2746,0,0,71,0,-71
2747,1,0,26,0,-26
2748,1,0,35,0,-35
2749,1,0,120,0,-120
2750,1,1,1515,1360,-155
2751,0,0,5,0,-5
2752,1,1,1052,1368,316
2753,0,0,9,0,-9
2754,0,0,22,0,-22
2755,1,0,42,0,-42
2756,0,0,16,0,-16
2757,1,1,610,1745,1135
2758,0,0,226,0,-226
2759,0,0,22,0,-22
2760,0,0,17,0,-17
2761,1,0,73,0,-73
2762,0,0,99,0,-99
2763,0,0,34,0,-34
2764,1,0,5,0,-5
2765,0,0,43,0,-43
2766,1,0,58,0,-58
2767,1,0,25,0,-25
2768,1,1,536,1243,707
2769,0,0,3,0,-3
2770,1,0,38,0,-38
2771,1,0,18,0,-18
2772,0,0,32,0,-32
2773,1,1,758,1555,797
2774,1,0,6,0,-6
2775,1,0,7,0,-7
2776,1,1,146,1805,1659
2777,1,0,23,0,-23
2778,1,0,91,0,-91
2779,1,0,89,0,-89
2780,1,1,130,1351,1221
2781,0,0,154,0,-154
2782,1,0,385,0,-385
2783,0,0,1,0,-1
2784,0,0,8,0,-8
2785,1,1,229,1438,1209
2786,1,0,44,0,-44
2787,1,0,16,0,-16
2788,1,1,412,2407,1995
2789,0,0,5,0,-5
2790,0,0,13,0,-13
2791,1,1,19,1863,1844
2792,0,0,3,0,-3
2793,0,0,9,0,-9
2794,1,0,39,0,-39
2795,1,0,43,0,-43
2796,1,0,7,0,-7
2797,0,0,82,0,-82
2798,1,0,59,0,-59
2799,0,0,10,0,-10
2800,1,0,32,0,-32
2801,0,0,73,0,-73
2802,1,1,333,1265,932
2803,0,0,16,0,-16
2804,1,0,15,0,-15
2805,0,0,26,0,-26
2806,1,0,18,0,-18
2807,1,1,295,1631,1336
2808,1,1,48,1912,1864
2809,1,0,58,0,-58
2810,1,1,301,1460,1159
2811,0,0,7,0,-7
2812,0,0,78,0,-78
2813,1,1,1389,1287,-102
2814,1,1,16,1554,1538
2815,0,0,81,0,-81
2816,0,0,26,0,-26
2817,1,0,52,0,-52
2818,0,0,9,0,-9
2819,1,0,0,0,0
2820,1,1,701,1488,787
2821,1,0,20,0,-20
2822,1,0,85,0,-85
2823,0,0,2,0,-2
2824,1,1,527,1420,893
2825,0,0,8,0,-8
2826,0,0,16,0,-16
2827,0,0,45,0,-45
2828,0,0,134,0,-134
2829,1,1,107,1774,1667
2830,1,0,112,0,-112
2831,0,0,18,0,-18
2832,0,0,89,0,-89
2833,0,0,13,0,-13
2834,1,0,30,0,-30
2835,0,0,35,0,-35
2836,1,0,91,0,-91
2837,0,0,38,0,-38
2838,0,0,29,0,-29
2839,1,1,63,1256,1193
2840,1,1,77,1602,1525
2841,1,0,29,0,-29
2842,1,0,42,0,-42
2843,0,0,103,0,-103
2844,1,1,261,1450,1189
2845,1,0,23,0,-23
2846,0,0,1,0,-1
2847,1,0,24,0,-24
2848,1,0,123,0,-123
2849,0,0,95,0,-95
2850,1,0,15,0,-15
2851,1,0,14,0,-14
2852,1,0,59,0,-59
2853,1,0,9,0,-9
2854,1,0,6,0,-6
2855,1,0,3,0,-3
2856,1,0,93,0,-93
2857,1,0,7,0,-7
2858,0,0,16,0,-16
2859,1,0,22,0,-22
2860,1,1,252,1726,1474
2861,1,0,99,0,-99
2862,0,0,4,0,-4
2863,0,0,56,0,-56
2864,1,1,514,1442,928
2865,1,1,623,1522,899
2866,1,1,173,1638,1465
2867,0,0,1,0,-1
2868,1,1,418,1261,843
2869,0,0,1,0,-1
2870,0,0,2,0,-2
2871,1,0,8,0,-8
2872,1,0,41,0,-41
2873,1,0,37,0,-37
2874,0,0,36,0,-36
2875,1,0,77,0,-77
2876,1,0,53,0,-53
2877,0,0,16,0,-16
2878,0,0,32,0,-32
2879,0,0,168,0,-168
2880,1,0,8,0,-8
2881,1,0,53,0,-53
2882,0,0,28,0,-28
2883,1,0,91,0,-91
2884,1,1,491,1544,1053
2885,0,0,17,0,-17
2886,1,0,29,0,-29
2887,1,0,82,0,-82
2888,0,0,6,0,-6
2889,0,0,33,0,-33
2890,1,0,180,0,-180
2891,1,0,8,0,-8
2892,0,0,58,0,-58
2893,1,0,43,0,-43
2894,0,0,42,0,-42
2895,0,0,19,0,-19
2896,0,0,1,0,-1
2897,0,0,30,0,-30
2898,1,1,1214,2691,1477
2899,1,1,380,1677,1297
2900,1,1,397,2383,1986
2901,1,0,33,0,-33
2902,1,0,48,0,-48
2903,1,1,1097,1499,402
2904,1,1,325,1558,1233
2905,1,0,24,0,-24
2906,0,0,8,0,-8
2907,0,0,55,0,-55
2908,1,1,1081,1844,763
2909,0,0,78,0,-78
2910,0,0,82,0,-82
2911,1,1,142,1680,1538
2912,0,0,23,0,-23
2913,1,1,1553,1247,-306
2914,1,1,116,1542,1426
2915,0,0,6,0,-6
2916,1,0,6,0,-6
2917,1,0,113,0,-113
2918,1,1,165,1380,1215
2919,1,1,654,1360,706
2920,0,0,7,0,-7
2921,0,0,7,0,-7
2922,1,1,122,1297,1175
2923,1,1,165,1274,1109
2924,1,1,725,1410,685
2925,1,0,3,0,-3
2926,0,0,180,0,-180
2927,1,0,116,0,-116
2928,1,1,1124,2191,1067
2929,1,0,62,0,-62
2930,0,0,13,0,-13
2931,0,0,39,0,-39
2932,1,0,28,0,-28
2933,1,0,15,0,-15
2934,1,0,13,0,-13
2935,1,0,36,0,-36
2936,0,0,16,0,-16
2937,0,0,87,0,-87
2938,1,1,1433,1290,-143
2939,0,0,87,0,-87
2940,0,0,22,0,-22
2941,1,0,6,0,-6
2942,1,0,54,0,-54
2943,0,0,6,0,-6
2944,1,0,17,0,-17
2945,0,0,10,0,-10
2946,0,0,4,0,-4
2947,1,1,23,1292,1269
2948,0,0,19,0,-19
2949,0,0,21,0,-21
2950,1,0,179,0,-179
2951,1,0,51,0,-51
2952,1,1,258,1415,1157
2953,0,0,130,0,-130
2954,1,1,156,1338,1182
2955,0,0,64,0,-64
2956,0,0,2,0,-2
2957,0,0,28,0,-28
2958,1,0,39,0,-39
2959,0,0,15,0,-15
2960,0,0,4,0,-4
2961,0,0,123,0,-123
2962,0,0,164,0,-164
2963,0,0,0,0,0
2964,0,0,80,0,-80
2965,0,0,41,0,-41
2966,1,1,197,1565,1368
2967,1,1,576,2160,1584
2968,1,0,64,0,-64
2969,0,0,0,0,0
2970,1,1,123,1288,1165
2971,0,0,20,0,-20
2972,0,0,67,0,-67
2973,1,1,575,1422,847
2974,0,0,2,0,-2
2975,1,0,0,0,0
2976,1,0,12,0,-12
2977,1,0,31,0,-31
2978,1,0,22,0,-22
2979,0,0,5,0,-5
2980,0,0,108,0,-108
2981,1,0,145,0,-145
2982,0,0,30,0,-30
2983,1,1,157,1284,1127
2984,0,0,251,0,-251
2985,1,0,70,0,-70
2986,0,0,1,0,-1
2987,1,0,25,0,-25
2988,0,0,39,0,-39
2989,0,0,51,0,-51
2990,1,0,17,0,-17
2991,1,0,163,0,-163
2992,0,0,44,0,-44
2993,0,0,32,0,-32
2994,1,1,375,1260,885
2995,0,0,11,0,-11
2996,0,0,46,0,-46
2997,1,1,838,1676,838
2998,1,1,301,1811,1510
2999,1,0,17,0,-17
3000,0,0,47,0,-47
3001,0,0,69,0,-69
3002,1,1,136,1236,1100
3003,1,1,824,1386,562
3004,1,1,205,1449,1244
3005,0,0,63,0,-63
3006,1,0,23,0,-23
3007,0,0,22,0,-22
3008,1,0,63,0,-63
3009,1,0,17,0,-17
3010,0,0,26,0,-26
3011,1,0,75,0,-75
3012,1,1,679,1236,557
3013,1,0,107,0,-107
3014,0,0,56,0,-56
3015,1,0,51,0,-51
3016,1,0,3,0,-3
3017,0,0,34,0,-34
3018,0,0,38,0,-38
3019,1,1,1311,1286,-25
3020,0,0,13,0,-13
3021,1,1,367,1284,917
3022,0,0,30,0,-30
3023,1,0,50,0,-50
3024,0,0,30,0,-30
3025,1,0,4,0,-4
3026,0,0,51,0,-51
3027,0,0,28,0,-28
3028,0,0,6,0,-6
3029,0,0,40,0,-40
3030,0,0,76,0,-76
3031,1,1,453,1778,1325
3032,1,1,642,1819,1177
3033,1,1,490,1827,1337
3034,1,1,277,1240,963
3035,0,0,44,0,-44
3036,1,0,188,0,-188
3037,1,0,65,0,-65
3038,1,0,215,0,-215
3039,0,0,149,0,-149
3040,1,1,18,1453,1435
3041,1,1,189,1348,1159
3042,0,0,205,0,-205
3043,1,1,174,1486,1312
3044,1,0,40,0,-40
3045,1,0,86,0,-86
3046,1,1,509,1545,1036
3047,0,0,62,0,-62
3048,1,1,2103,1281,-822
3049,1,1,886,1577,691
3050,1,1,48,1422,1374
3051,1,0,42,0,-42
3052,1,0,46,0,-46
3053,1,1,132,1353,1221
3054,1,1,432,1375,943
3055,0,0,16,0,-16
3056,0,0,57,0,-57
3057,1,1,618,2131,1513
3058,0,0,5,0,-5
3059,0,0,22,0,-22
3060,1,1,553,1741,1188
3061,1,1,887,1412,525
3062,1,1,388,1319,931
3063,1,1,694,1464,770
3064,1,0,29,0,-29
3065,0,0,214,0,-214
3066,0,0,34,0,-34
3067,1,0,43,0,-43
3068,1,0,47,0,-47
3069,1,0,95,0,-95
3070,1,0,10,0,-10
3071,0,0,64,0,-64
3072,1,1,624,1470,846
3073,1,0,175,0,-175
3074,0,0,7,0,-7
3075,0,0,53,0,-53
3076,1,1,791,1339,548
3077,1,0,17,0,-17
3078,0,0,76,0,-76
3079,1,0,40,0,-40
3080,1,0,121,0,-121
3081,1,0,5,0,-5
3082,1,1,1090,1379,289
3083,0,0,26,0,-26
3084,1,1,863,1803,940
3085,1,1,1095,1414,319
3086,1,0,17,0,-17
3087,1,0,23,0,-23
3088,1,1,366,1387,1021
3089,1,0,108,0,-108
3090,0,0,9,0,-9
3091,1,1,769,1884,1115
3092,1,1,1310,1320,10
3093,0,0,115,0,-115
3094,0,0,25,0,-25
3095,1,1,559,3013,2454
3096,1,1,651,1254,603
3097,0,0,184,0,-184
3098,0,0,74,0,-74
3099,1,1,977,1499,522
3100,1,0,1,0,-1
3101,0,0,31,0,-31
3102,0,0,0,0,0
3103,1,1,521,1467,946
3104,0,0,8,0,-8
3105,0,0,45,0,-45
3106,0,0,101,0,-101
3107,1,1,254,1388,1134
3108,0,0,91,0,-91
3109,1,0,5,0,-5
3110,0,0,187,0,-187
3111,1,0,86,0,-86
3112,1,0,3,0,-3
3113,0,0,63,0,-63
3114,0,0,22,0,-22
3115,1,1,95,1524,1429
3116,0,0,194,0,-194
3117,1,0,32,0,-32
3118,1,0,8,0,-8
3119,1,1,39,1487,1448
3120,0,0,59,0,-59
3121,0,0,114,0,-114
3122,1,0,65,0,-65
3123,1,0,25,0,-25
3124,0,0,79,0,-79
3125,0,0,61,0,-61
3126,0,0,1,0,-1
3127,1,0,4,0,-4
3128,1,0,80,0,-80
3129,1,0,59,0,-59
3130,0,0,9,0,-9
3131,0,0,52,0,-52
3132,1,0,34,0,-34
3133,0,0,29,0,-29
3134,1,0,92,0,-92
3135,1,1,348,1508,1160
3136,1,0,41,0,-41
3137,0,0,17,0,-17
3138,1,1,675,1619,944
3139,0,0,56,0,-56
3140,0,0,70,0,-70
3141,0,0,63,0,-63
3142,0,0,37,0,-37
3143,1,0,26,0,-26
3144,1,0,8,0,-8
3145,1,0,5,0,-5
3146,0,0,107,0,-107
3147,1,1,58,1537,1479
3148,0,0,31,0,-31
3149,0,0,138,0,-138
3150,0,0,81,0,-81
3151,0,0,85,0,-85
3152,1,1,120,1434,1314
3153,0,0,45,0,-45
3154,0,0,13,0,-13
3155,1,0,106,0,-106
3156,1,1,4,1400,1396
3157,1,1,583,1258,675
3158,1,0,131,0,-131
3159,1,1,332,1393,1061
3160,1,0,4,0,-4
3161,1,1,303,2327,2024
3162,0,0,88,0,-88
3163,0,0,12,0,-12
3164,1,0,14,0,-14
3165,1,0,54,0,-54
3166,1,0,126,0,-126
3167,0,0,77,0,-77
3168,0,0,92,0,-92
3169,0,0,38,0,-38
3170,0,0,82,0,-82
3171,1,1,646,1761,1115
3172,1,0,100,0,-100
3173,0,0,42,0,-42
3174,1,1,2912,1342,-1570
3175,1,0,34,0,-34
3176,1,0,2,0,-2
3177,0,0,45,0,-45
3178,0,0,20,0,-20
3179,1,1,322,1917,1595
3180,1,0,45,0,-45
3181,0,0,74,0,-74
3182,1,0,8,0,-8
3183,0,0,20,0,-20
3184,1,1,200,1263,1063
3185,0,0,13,0,-13
3186,1,0,110,0,-110
3187,1,0,165,0,-165
3188,1,0,108,0,-108
3189,0,0,22,0,-22
3190,1,0,76,0,-76
3191,1,1,109,1492,1383
3192,1,0,6,0,-6
3193,0,0,31,0,-31
3194,1,0,22,0,-22
3195,0,0,3,0,-3
3196,1,1,567,1519,952
3197,1,1,78,1236,1158
3198,0,0,42,0,-42
3199,0,0,44,0,-44
3200,0,0,39,0,-39
3201,1,1,417,1306,889
3202,1,1,3998,1369,-2629
3203,0,0,18,0,-18
3204,1,1,266,1942,1676
3205,1,0,7,0,-7
3206,0,0,78,0,-78
3207,0,0,14,0,-14
3208,0,0,162,0,-162
3209,1,1,243,1522,1279
3210,1,1,335,1246,911
3211,1,0,9,0,-9
3212,1,1,716,1583,867
3213,1,0,31,0,-31
3214,0,0,131,0,-131
3215,0,0,79,0,-79
3216,0,0,9,0,-9
3217,1,0,59,0,-59
3218,0,0,68,0,-68
3219,1,0,26,0,-26
3220,0,0,30,0,-30
3221,0,0,1,0,-1
3222,1,1,495,1483,988
3223,0,0,94,0,-94
3224,0,0,85,0,-85
3225,1,0,7,0,-7
3226,0,0,16,0,-16
3227,0,0,67,0,-67
3228,1,1,249,1253,1004
3229,1,0,79,0,-79
3230,0,0,34,0,-34
3231,0,0,1,0,-1
3232,1,0,0,0,0
3233,1,1,632,1529,897
3234,1,0,7,0,-7
3235,1,0,23,0,-23
3236,1,0,7,0,-7
3237,0,0,12,0,-12
3238,1,1,396,1747,1351
3239,1,0,35,0,-35
3240,0,0,26,0,-26
3241,1,1,626,1243,617
3242,0,0,23,0,-23
3243,0,0,103,0,-103
3244,1,0,65,0,-65
3245,1,1,684,1304,620
3246,1,0,106,0,-106
3247,1,1,228,2429,2201
3248,0,0,26,0,-26
3249,1,1,431,1327,896
3250,1,1,352,1256,904
3251,0,0,61,0,-61
3252,1,1,679,1507,828
3253,1,1,50,1627,1577
3254,1,0,7,0,-7
3255,1,0,12,0,-12
3256,1,0,31,0,-31
3257,1,0,8,0,-8
3258,1,1,976,3324,2348
3259,0,0,48,0,-48
3260,0,0,3,0,-3
3261,0,0,20,0,-20
3262,1,1,153,1397,1244
3263,0,0,2,0,-2
3264,0,0,27,0,-27
3265,1,1,736,1374,638
3266,1,0,56,0,-56
3267,1,0,9,0,-9
3268,0,0,59,0,-59
3269,1,0,79,0,-79
3270,0,0,84,0,-84
3271,0,0,15,0,-15
3272,0,0,112,0,-112
3273,0,0,18,0,-18
3274,0,0,20,0,-20
3275,0,0,8,0,-8
3276,0,0,9,0,-9
3277,1,0,3,0,-3
3278,1,0,193,0,-193
3279,0,0,75,0,-75
3280,0,0,69,0,-69
3281,1,0,7,0,-7
3282,1,0,166,0,-166
3283,1,0,36,0,-36
3284,1,1,195,1265,1070
3285,0,0,31,0,-31
3286,0,0,63,0,-63
3287,1,0,26,0,-26
3288,1,1,135,2607,2472
3289,1,0,54,0,-54
3290,1,0,17,0,-17
3291,0,0,16,0,-16
3292,1,0,24,0,-24
3293,0,0,22,0,-22
3294,0,0,76,0,-76
3295,1,1,601,1438,837
3296,1,0,81,0,-81
3297,0,0,8,0,-8
3298,1,1,318,2431,2113
3299,1,1,915,1764,849
3300,0,0,62,0,-62
3301,1,0,4,0,-4
3302,1,1,1135,1782,647
3303,1,1,187,1339,1152
3304,0,0,3,0,-3
3305,1,0,62,0,-62
3306,1,0,16,0,-16
3307,0,0,3,0,-3
3308,0,0,100,0,-100
3309,1,0,1,0,-1
3310,1,1,197,1440,1243
3311,0,0,13,0,-13
3312,0,0,23,0,-23
3313,1,0,94,0,-94
3314,1,0,12,0,-12
3315,0,0,51,0,-51
3316,0,0,43,0,-43
3317,1,1,1429,1474,45
3318,1,1,498,1383,885
3319,1,0,13,0,-13
3320,1,0,65,0,-65
3321,1,0,5,0,-5
3322,1,0,64,0,-64
3323,1,1,322,1282,960
3324,0,0,38,0,-38
3325,0,0,7,0,-7
3326,0,0,104,0,-104
3327,1,0,156,0,-156
3328,1,1,32,1388,1356
3329,1,0,51,0,-51
3330,1,1,90,1582,1492
3331,0,0,83,0,-83
3332,0,0,25,0,-25
3333,0,0,40,0,-40
3334,0,0,38,0,-38
3335,0,0,57,0,-57
3336,0,0,26,0,-26
3337,1,0,35,0,-35
3338,1,1,223,3035,2812
3339,1,1,1597,1289,-308
3340,1,0,1,0,-1
3341,1,0,4,0,-4
3342,1,1,331,1340,1009
3343,1,0,6,0,-6
3344,0,0,118,0,-118
3345,1,1,133,1455,1322
3346,0,0,22,0,-22
3347,1,1,585,1449,864
3348,0,0,58,0,-58
3349,1,1,79,1438,1359
3350,1,0,148,0,-148
3351,0,0,39,0,-39
3352,0,0,70,0,-70
3353,0,0,52,0,-52
3354,1,1,410,1547,1137
3355,1,0,186,0,-186
3356,0,0,16,0,-16
3357,1,1,1517,1708,191
3358,1,0,17,0,-17
3359,1,1,205,1348,1143
3360,0,0,96,0,-96
3361,1,0,74,0,-74
3362,1,1,283,1925,1642
3363,1,0,25,0,-25
3364,1,0,78,0,-78
3365,1,1,597,1777,1180
3366,0,0,3,0,-3
3367,1,1,219,1654,1435
3368,0,0,5,0,-5
3369,0,0,144,0,-144
3370,0,0,3,0,-3
3371,1,1,350,1572,1222
3372,1,0,15,0,-15
3373,1,0,104,0,-104
3374,1,1,1636,1757,121
3375,1,0,23,0,-23
3376,1,1,3023,1254,-1769
3377,1,0,64,0,-64
3378,0,0,20,0,-20
3379,0,0,23,0,-23
3380,1,0,112,0,-112
3381,1,0,38,0,-38
3382,1,0,18,0,-18
3383,0,0,12,0,-12
3384,1,1,108,2109,2001
3385,1,0,9,0,-9
3386,0,0,23,0,-23
3387,1,0,61,0,-61
3388,0,0,59,0,-59
3389,0,0,13,0,-13
3390,1,1,877,1484,607
3391,1,1,619,1785,1166
3392,1,0,1,0,-1
3393,0,0,38,0,-38
3394,1,0,56,0,-56
3395,0,0,51,0,-51
3396,1,1,386,1346,960
3397,1,0,23,0,-23
3398,0,0,14,0,-14
3399,0,0,47,0,-47
3400,1,1,165,1429,1264
3401,0,0,2,0,-2
3402,1,1,141,1283,1142
3403,0,0,1,0,-1
3404,1,0,54,0,-54
3405,1,0,61,0,-61
3406,0,0,50,0,-50
3407,1,1,591,1584,993
3408,1,0,87,0,-87
3409,1,1,94,2309,2215
3410,0,0,76,0,-76
3411,1,1,1559,1251,-308
3412,0,0,47,0,-47
3413,0,0,39,0,-39
3414,0,0,84,0,-84
3415,0,0,9,0,-9
3416,1,0,74,0,-74
3417,1,0,30,0,-30
3418,1,0,2,0,-2
3419,1,0,136,0,-136
3420,0,0,14,0,-14
3421,1,0,34,0,-34
3422,0,0,92,0,-92
3423,1,0,88,0,-88
3424,1,0,36,0,-36
3425,0,0,92,0,-92
3426,1,1,1713,1332,-381
3427,0,0,20,0,-20
3428,1,0,5,0,-5
3429,0,0,63,0,-63
3430,1,0,0,0,0
3431,0,0,24,0,-24
3432,0,0,40,0,-40
3433,1,0,76,0,-76
3434,1,0,135,0,-135
3435,1,1,599,1914,1315
3436,1,1,1128,1324,196
3437,0,0,40,0,-40
3438,1,1,449,1315,866
3439,1,1,379,1683,1304
3440,1,0,84,0,-84
3441,1,1,66,2703,2637
3442,1,1,47,1694,1647
3443,0,0,5,0,-5
3444,1,0,5,0,-5
3445,1,0,9,0,-9
3446,0,0,40,0,-40
3447,1,1,57,1271,1214
3448,0,0,0,0,0
3449,1,1,580,2444,1864
3450,1,1,42,1558,1516
3451,0,0,6,0,-6
3452,0,0,38,0,-38
3453,1,1,249,2358,2109
3454,1,0,12,0,-12
3455,0,0,129,0,-129
3456,0,0,3,0,-3
3457,0,0,31,0,-31
3458,1,1,904,1877,973
3459,1,1,33,2132,2099
3460,0,0,173,0,-173
3461,1,1,479,2694,2215
3462,0,0,118,0,-118
3463,1,0,8,0,-8
3464,1,1,323,1440,1117
3465,0,0,80,0,-80
3466,1,1,836,1697,861
3467,0,0,74,0,-74
3468,1,0,91,0,-91
3469,1,0,8,0,-8
3470,0,0,58,0,-58
3471,1,1,355,1465,1110
3472,1,0,67,0,-67
3473,0,0,158,0,-158
3474,0,0,18,0,-18
3475,1,1,289,1419,1130
3476,1,1,360,1328,968
3477,1,1,318,1541,1223
3478,0,0,25,0,-25
3479,1,1,519,1431,912
3480,1,0,29,0,-29
3481,0,0,59,0,-59
3482,1,1,3133,1404,-1729
3483,0,0,147,0,-147
3484,0,0,15,0,-15
3485,1,1,194,1523,1329
3486,1,1,366,1386,1020
3487,0,0,92,0,-92
3488,1,0,31,0,-31
3489,1,1,236,2679,2443
3490,1,0,271,0,-271
3491,0,0,0,0,0
3492,1,0,21,0,-21
3493,0,0,0,0,0
3494,0,0,298,0,-298
3495,0,0,54,0,-54
3496,1,0,4,0,-4
3497,0,0,10,0,-10
3498,1,1,84,2704,2620
3499,0,0,6,0,-6
3500,1,0,49,0,-49
3501,1,1,1121,1630,509
3502,1,1,134,1275,1141
3503,0,0,38,0,-38
3504,0,0,72,0,-72
3505,0,0,29,0,-29
3506,1,1,1168,2438,1270
3507,1,1,162,1408,1246
3508,1,1,628,1485,857
3509,1,1,193,1315,1122
3510,1,1,73,3713,3640
3511,0,0,177,0,-177
3512,1,1,575,1360,785
3513,0,0,14,0,-14
3514,1,1,140,2150,2010
3515,1,0,13,0,-13
3516,0,0,47,0,-47
3517,1,1,465,1462,997
3518,1,1,287,4246,3959
3519,1,0,6,0,-6
3520,0,0,281,0,-281
3521,1,1,1063,1454,391
3522,1,0,59,0,-59
3523,0,0,8,0,-8
3524,1,0,7,0,-7
3525,1,0,17,0,-17
3526,1,0,46,0,-46
3527,1,0,15,0,-15
3528,1,1,906,1402,496
3529,1,0,110,0,-110
3530,1,0,9,0,-9
3531,0,0,12,0,-12
3532,0,0,21,0,-21
3533,1,1,476,1269,793
3534,1,1,283,1395,1112
3535,0,0,80,0,-80
3536,0,0,84,0,-84
3537,0,0,31,0,-31
3538,0,0,51,0,-51
3539,0,0,107,0,-107
3540,1,1,812,1295,483
3541,0,0,44,0,-44
3542,0,0,36,0,-36
3543,0,0,8,0,-8
3544,0,0,6,0,-6
3545,1,1,56,2553,2497
3546,1,0,3,0,-3
3547,0,0,46,0,-46
3548,1,0,237,0,-237
3549,0,0,55,0,-55
3550,0,0,3,0,-3
3551,1,1,697,1453,756
3552,1,1,2043,1600,-443
3553,0,0,43,0,-43
3554,0,0,24,0,-24
3555,0,0,80,0,-80
3556,0,0,33,0,-33
3557,0,0,94,0,-94
3558,1,0,31,0,-31
3559,1,0,45,0,-45
3560,1,0,78,0,-78
3561,1,0,40,0,-40
3562,0,0,72,0,-72
3563,0,0,60,0,-60
3564,0,0,16,0,-16
3565,0,0,49,0,-49
3566,1,1,1301,1473,172
3567,0,0,12,0,-12
3568,1,0,26,0,-26
3569,1,1,154,1715,1561
3570,1,1,547,1441,894
3571,1,0,7,0,-7
3572,0,0,12,0,-12
3573,0,0,11,0,-11
3574,1,0,25,0,-25
3575,1,0,49,0,-49
3576,0,0,76,0,-76
3577,0,0,86,0,-86
3578,0,0,25,0,-25
3579,1,1,219,1303,1084
3580,1,0,3,0,-3
3581,1,0,51,0,-51
3582,1,0,8,0,-8
3583,1,1,207,1244,1037
3584,1,1,369,1363,994
3585,0,0,62,0,-62
3586,0,0,266,0,-266
3587,1,0,33,0,-33
3588,0,0,10,0,-10
3589,1,0,58,0,-58
3590,0,0,6,0,-6
3591,0,0,39,0,-39
3592,1,0,2,0,-2
3593,1,0,109,0,-109
3594,0,0,163,0,-163
3595,1,1,30,1784,1754
3596,0,0,40,0,-40
3597,0,0,153,0,-153
3598,0,0,121,0,-121
3599,1,0,46,0,-46
3600,0,0,19,0,-19
3601,0,0,75,0,-75
3602,0,0,24,0,-24
3603,1,0,2,0,-2
3604,1,1,1358,1877,519
3605,1,1,56,1365,1309
3606,1,0,159,0,-159
3607,1,1,598,2325,1727
3608,0,0,108,0,-108
3609,0,0,1,0,-1
3610,0,0,27,0,-27
3611,1,1,1143,1304,161
3612,1,1,943,1401,458
3613,0,0,69,0,-69
3614,0,0,164,0,-164
3615,1,1,496,1731,1235
3616,0,0,20,0,-20
3617,0,0,120,0,-120
3618,0,0,41,0,-41
3619,0,0,26,0,-26
3620,0,0,23,0,-23
3621,1,0,84,0,-84
3622,1,1,717,3303,2586
3623,0,0,119,0,-119
3624,1,0,18,0,-18
3625,1,1,413,1264,851
3626,0,0,30,0,-30
3627,0,0,315,0,-315
3628,0,0,29,0,-29
3629,1,0,35,0,-35
3630,0,0,14,0,-14
3631,0,0,13,0,-13
3632,1,0,153,0,-153
3633,1,1,147,1361,1214
3634,1,1,273,1526,1253
3635,0,0,290,0,-290
3636,1,1,879,1261,382
3637,0,0,34,0,-34
3638,0,0,117,0,-117
3639,0,0,148,0,-148
3640,0,0,50,0,-50
3641,0,0,9,0,-9
3642,0,0,21,0,-21
3643,1,1,1012,2779,1767
3644,0,0,33,0,-33
3645,1,0,53,0,-53
3646,1,0,182,0,-182
3647,1,1,244,1725,1481
3648,0,0,56,0,-56
3649,1,0,194,0,-194
3650,1,0,101,0,-101
3651,0,0,38,0,-38
3652,1,1,870,1240,370
3653,1,1,937,1262,325
3654,0,0,5,0,-5
3655,1,1,792,1751,959
3656,1,0,30,0,-30
3657,1,1,141,1881,1740
3658,1,1,917,1346,429
3659,1,0,86,0,-86
3660,1,1,287,1241,954
3661,0,0,149,0,-149
3662,0,0,89,0,-89
3663,1,1,230,1665,1435
3664,0,0,14,0,-14
3665,1,1,532,1737,1205
3666,1,0,19,0,-19
3667,1,0,16,0,-16
3668,1,0,23,0,-23
3669,0,0,7,0,-7
3670,0,0,65,0,-65
3671,1,0,21,0,-21
3672,1,0,13,0,-13
3673,0,0,106,0,-106
3674,1,0,22,0,-22
3675,1,0,0,0,0
3676,0,0,254,0,-254
3677,0,0,8,0,-8
3678,1,0,32,0,-32
3679,1,1,1307,1335,28
3680,1,1,670,1237,567
3681,0,0,40,0,-40
3682,1,1,126,1315,1189
3683,1,0,118,0,-118
3684,1,1,1120,1460,340
3685,0,0,78,0,-78
3686,1,0,28,0,-28
3687,1,1,794,1419,625
3688,1,1,545,1363,818
3689,1,1,91,1315,1224
3690,0,0,68,0,-68
3691,1,0,15,0,-15
3692,0,0,36,0,-36
3693,1,0,20,0,-20
3694,0,0,25,0,-25
3695,1,0,17,0,-17
3696,0,0,58,0,-58
3697,1,1,497,1373,876
3698,0,0,77,0,-77
3699,1,0,18,0,-18
3700,1,0,33,0,-33
3701,1,0,156,0,-156
3702,1,1,201,1665,1464
3703,0,0,100,0,-100
3704,1,0,87,0,-87
3705,0,0,49,0,-49
3706,1,0,6,0,-6
3707,0,0,89,0,-89
3708,1,1,353,1351,998
3709,0,0,25,0,-25
3710,0,0,34,0,-34
3711,1,1,322,1652,1330
3712,0,0,0,0,0
3713,1,1,660,2411,1751
3714,1,0,27,0,-27
3715,1,0,33,0,-33
3716,1,1,417,1512,1095
3717,0,0,6,0,-6
3718,0,0,1,0,-1
3719,0,0,4,0,-4
3720,1,1,757,1266,509
3721,1,0,54,0,-54
3722,1,0,56,0,-56
3723,1,0,29,0,-29
3724,1,1,282,1386,1104
3725,0,0,6,0,-6
3726,0,0,2,0,-2
3727,0,0,26,0,-26
3728,1,0,36,0,-36
3729,0,0,36,0,-36
3730,1,1,274,1247,973
3731,1,0,18,0,-18
3732,1,0,46,0,-46
3733,0,0,16,0,-16
3734,1,1,707,1551,844
3735,1,0,11,0,-11
3736,1,1,120,1575,1455
3737,1,1,98,1323,1225
3738,1,1,1852,1601,-251
3739,0,0,16,0,-16
3740,1,0,25,0,-25
3741,0,0,22,0,-22
3742,0,0,52,0,-52
3743,1,1,204,1335,1131
3744,1,1,148,1428,1280
3745,0,0,146,0,-146
3746,1,0,72,0,-72
3747,1,1,380,1383,1003
3748,0,0,65,0,-65
3749,0,0,23,0,-23
3750,1,1,1129,1287,158
3751,0,0,3,0,-3
3752,1,1,924,1666,742
3753,0,0,83,0,-83
3754,0,0,6,0,-6
3755,0,0,105,0,-105
3756,1,0,7,0,-7
3757,1,0,43,0,-43
3758,0,0,21,0,-21
3759,1,1,562,1640,1078
3760,0,0,128,0,-128
3761,1,1,669,1339,670
3762,0,0,204,0,-204
3763,0,0,138,0,-138
3764,0,0,36,0,-36
3765,1,0,47,0,-47
3766,0,0,41,0,-41
3767,0,0,103,0,-103
3768,0,0,12,0,-12
3769,1,1,926,1986,1060
3770,1,1,747,1279,532
3771,0,0,31,0,-31
3772,0,0,21,0,-21
3773,0,0,11,0,-11
3774,0,0,138,0,-138
3775,0,0,1,0,-1
3776,1,1,76,1337,1261
3777,0,0,25,0,-25
3778,1,1,312,1399,1087
3779,1,1,510,1505,995
3780,1,1,1584,1322,-262
3781,0,0,34,0,-34
3782,1,0,6,0,-6
3783,0,0,26,0,-26
3784,0,0,1,0,-1
3785,1,0,63,0,-63
3786,1,1,1312,1544,232
3787,1,0,105,0,-105
3788,1,1,225,1800,1575
3789,0,0,35,0,-35
3790,1,0,57,0,-57
3791,1,0,139,0,-139
3792,0,0,3,0,-3
3793,1,1,488,1306,818
3794,0,0,19,0,-19
3795,0,0,41,0,-41
3796,0,0,31,0,-31
3797,1,0,13,0,-13
3798,1,0,12,0,-12
3799,0,0,9,0,-9
3800,0,0,14,0,-14
3801,0,0,49,0,-49
3802,0,0,217,0,-217
3803,0,0,72,0,-72
3804,1,1,378,1261,883
3805,1,1,694,1345,651
3806,1,1,113,1243,1130
3807,1,0,30,0,-30
3808,0,0,3,0,-3
3809,1,1,34,1485,1451
3810,1,0,25,0,-25
3811,1,1,608,1301,693
3812,0,0,52,0,-52
3813,1,1,308,1465,1157
3814,0,0,44,0,-44
3815,1,1,448,1415,967
3816,1,1,11,1970,1959
3817,1,0,38,0,-38
3818,1,1,610,3363,2753
3819,1,0,7,0,-7
3820,1,0,19,0,-19
3821,1,0,160,0,-160
3822,0,0,21,0,-21
3823,0,0,109,0,-109
3824,0,0,161,0,-161
3825,1,1,1038,1253,215
3826,1,0,37,0,-37
3827,1,0,1,0,-1
3828,1,1,325,1294,969
3829,0,0,15,0,-15
3830,1,1,533,1291,758
3831,1,1,1213,1814,601
3832,1,1,102,1250,1148
3833,0,0,69,0,-69
3834,1,1,32,3082,3050
3835,0,0,110,0,-110
3836,1,0,2,0,-2
3837,0,0,43,0,-43
3838,1,1,105,1361,1256
3839,1,1,568,1393,825
3840,1,1,134,1413,1279
3841,1,0,14,0,-14
3842,0,0,7,0,-7
3843,0,0,134,0,-134
3844,0,0,165,0,-165
3845,1,0,12,0,-12
3846,1,0,173,0,-173
3847,1,0,58,0,-58
3848,1,0,158,0,-158
3849,1,1,1185,1636,451
3850,0,0,226,0,-226
3851,1,0,33,0,-33
3852,1,1,926,1241,315
3853,1,0,81,0,-81
3854,1,0,16,0,-16
3855,1,0,8,0,-8
3856,1,1,288,1474,1186
3857,1,1,31,1513,1482
3858,0,0,42,0,-42
3859,0,0,65,0,-65
3860,1,1,219,1393,1174
3861,1,1,1293,1605,312
3862,0,0,83,0,-83
3863,1,0,189,0,-189
3864,1,1,2444,1713,-731
3865,1,1,964,1432,468
3866,1,1,117,2826,2709
3867,0,0,38,0,-38
3868,1,0,6,0,-6
3869,1,0,2,0,-2
3870,0,0,45,0,-45
3871,1,0,90,0,-90
3872,1,0,18,0,-18
3873,0,0,59,0,-59
3874,1,0,38,0,-38
3875,0,0,31,0,-31
3876,1,1,1446,2061,615
3877,1,1,1781,1745,-36
3878,1,1,388,1810,1422
3879,1,0,28,0,-28
3880,1,0,33,0,-33
3881,1,0,4,0,-4
3882,0,0,9,0,-9
3883,1,1,199,2012,1813
3884,0,0,19,0,-19
3885,1,0,32,0,-32
3886,0,0,47,0,-47
3887,0,0,67,0,-67
3888,1,0,0,0,0
3889,0,0,62,0,-62
3890,0,0,48,0,-48
3891,1,0,37,0,-37
3892,0,0,32,0,-32
3893,1,1,544,1525,981
3894,1,0,103,0,-103
3895,0,0,64,0,-64
3896,0,0,144,0,-144
3897,1,1,243,1392,1149
3898,1,0,5,0,-5
3899,1,0,104,0,-104
3900,1,0,73,0,-73
3901,1,1,225,1285,1060
3902,1,0,0,0,0
3903,1,0,3,0,-3
3904,1,1,375,1862,1487
3905,1,0,1,0,-1
3906,0,0,57,0,-57
3907,1,1,549,1420,871
3908,1,1,393,1296,903
3909,0,0,26,0,-26
3910,0,0,29,0,-29
3911,1,0,109,0,-109
3912,1,1,423,1240,817
3913,1,0,88,0,-88
3914,0,0,57,0,-57
3915,1,1,367,1935,1568
3916,0,0,6,0,-6
3917,1,1,230,1437,1207
3918,1,0,37,0,-37
3919,0,0,187,0,-187
3920,0,0,33,0,-33
3921,0,0,78,0,-78
3922,1,1,1257,1474,217
3923,0,0,25,0,-25
3924,0,0,19,0,-19
3925,1,0,86,0,-86
3926,1,0,30,0,-30
3927,1,0,11,0,-11
3928,0,0,32,0,-32
3929,0,0,9,0,-9
3930,0,0,75,0,-75
3931,1,1,271,1929,1658
3932,1,0,16,0,-16
3933,1,0,98,0,-98
3934,1,1,76,2097,2021
3935,0,0,4,0,-4
3936,1,0,35,0,-35
3937,0,0,41,0,-41
3938,0,0,89,0,-89
3939,1,1,1517,1450,-67
3940,1,0,136,0,-136
3941,0,0,23,0,-23
3942,1,1,25,2851,2826
3943,1,1,318,2524,2206
3944,0,0,29,0,-29
3945,1,0,103,0,-103
3946,1,0,19,0,-19
3947,0,0,5,0,-5
3948,1,0,56,0,-56
3949,1,0,35,0,-35
3950,1,1,1252,1314,62
3951,0,0,58,0,-58
3952,1,1,215,1308,1093
3953,1,0,0,0,0
3954,1,0,25,0,-25
3955,1,1,1724,1628,-96
3956,1,0,6,0,-6
3957,1,0,2,0,-2
3958,1,1,376,1980,1604
3959,1,1,97,1353,1256
3960,0,0,131,0,-131
3961,0,0,62,0,-62
3962,0,0,4,0,-4
3963,1,1,346,1283,937
3964,1,0,77,0,-77
3965,1,1,112,1287,1175
3966,1,1,2013,1377,-636
3967,1,0,22,0,-22
3968,0,0,79,0,-79
3969,0,0,4,0,-4
3970,1,0,4,0,-4
3971,0,0,45,0,-45
3972,1,0,68,0,-68
3973,1,1,627,1465,838
3974,1,0,122,0,-122
3975,1,0,2,0,-2
3976,0,0,40,0,-40
3977,0,0,8,0,-8
3978,1,0,226,0,-226
3979,0,0,29,0,-29
3980,0,0,1,0,-1
3981,1,0,2,0,-2
3982,1,0,88,0,-88
3983,1,0,9,0,-9
3984,1,1,151,1467,1316
3985,0,0,3,0,-3
3986,1,0,8,0,-8
3987,1,1,449,1298,849
3988,0,0,111,0,-111
3989,1,0,2,0,-2
3990,0,0,45,0,-45
3991,0,0,56,0,-56
3992,0,0,4,0,-4
3993,0,0,2,0,-2
3994,1,1,1305,1316,11
3995,0,0,14,0,-14
3996,1,1,2602,1243,-1359
3997,0,0,23,0,-23
3998,1,1,817,1266,449
3999,0,0,14,0,-14
4000,1,0,10,0,-10
4001,0,0,25,0,-25
4002,1,0,123,0,-123
4003,1,0,78,0,-78
4004,1,0,35,0,-35
4005,0,0,2,0,-2
4006,0,0,38,0,-38
4007,1,0,18,0,-18
4008,0,0,12,0,-12
4009,1,0,126,0,-126
4010,1,1,156,1299,1143
4011,1,1,417,1388,971
4012,0,0,147,0,-147
4013,1,0,41,0,-41
4014,1,1,1108,1605,497
4015,1,0,2,0,-2
4016,0,0,26,0,-26
4017,1,1,990,1617,627
4018,1,0,186,0,-186
4019,1,0,25,0,-25
4020,0,0,21,0,-21
4021,0,0,43,0,-43
4022,1,1,386,1687,1301
4023,1,0,26,0,-26
4024,1,0,11,0,-11
4025,1,0,18,0,-18
4026,1,1,569,1427,858
4027,1,0,4,0,-4
4028,1,0,37,0,-37
4029,1,1,131,1238,1107
4030,0,0,14,0,-14
4031,1,0,51,0,-51
4032,1,1,410,1388,978
4033,1,0,165,0,-165
4034,1,0,8,0,-8
4035,0,0,25,0,-25
4036,0,0,68,0,-68
4037,0,0,5,0,-5
4038,0,0,6,0,-6
4039,1,1,365,2101,1736
4040,1,1,249,2750,2501
4041,1,1,180,1934,1754
4042,1,1,792,1596,804
4043,1,1,1230,2119,889
4044,1,0,32,0,-32
4045,1,0,36,0,-36
4046,0,0,17,0,-17
4047,1,1,350,1359,1009
4048,0,0,25,0,-25
4049,1,1,77,1358,1281
4050,1,0,82,0,-82
4051,1,0,38,0,-38
4052,1,1,1149,1618,469
4053,1,0,148,0,-148
4054,0,0,19,0,-19
4055,1,1,138,1357,1219
4056,1,1,243,1290,1047
4057,1,1,332,1294,962
4058,0,0,21,0,-21
4059,0,0,0,0,0
4060,1,0,20,0,-20
4061,1,1,1443,1248,-195
4062,1,0,59,0,-59
4063,0,0,52,0,-52
4064,1,0,2,0,-2
4065,1,0,97,0,-97
4066,1,1,710,1405,695
4067,1,1,125,1286,1161
4068,1,1,296,1886,1590
4069,0,0,12,0,-12
4070,1,1,689,1282,593
4071,1,1,643,1313,670
4072,1,0,96,0,-96
4073,1,0,10,0,-10
4074,0,0,10,0,-10
4075,0,0,45,0,-45
4076,0,0,12,0,-12
4077,1,1,549,1248,699
4078,0,0,22,0,-22
4079,0,0,28,0,-28
4080,1,0,137,0,-137
4081,1,1,2043,1646,-397
4082,1,1,1086,2097,1011
4083,0,0,41,0,-41
4084,1,0,89,0,-89
4085,1,0,46,0,-46
4086,1,1,1171,1277,106
4087,0,0,33,0,-33
4088,0,0,22,0,-22
4089,0,0,107,0,-107
4090,1,0,251,0,-251
4091,1,1,82,1609,1527
4092,0,0,48,0,-48
4093,1,1,230,1553,1323
4094,1,0,5,0,-5
4095,1,0,59,0,-59
4096,0,0,54,0,-54
4097,1,0,34,0,-34
4098,0,0,207,0,-207
4099,0,0,29,0,-29
4100,1,1,1659,1414,-245
4101,0,0,10,0,-10
4102,1,1,510,1279,769
4103,0,0,7,0,-7
4104,1,1,742,1252,510
4105,1,0,26,0,-26
4106,0,0,5,0,-5
4107,1,1,114,1280,1166
4108,1,0,38,0,-38
4109,0,0,28,0,-28
4110,1,1,438,1382,944
4111,0,0,24,0,-24
4112,1,0,4,0,-4
4113,1,1,497,1303,806
4114,0,0,2,0,-2
4115,1,1,137,1511,1374
4116,1,0,7,0,-7
4117,0,0,107,0,-107
4118,0,0,5,0,-5
4119,0,0,132,0,-132
4120,1,1,77,1360,1283
4121,1,1,311,1650,1339
4122,0,0,42,0,-42
4123,1,1,27,1471,1444
4124,1,0,8,0,-8
4125,1,1,196,3233,3037
4126,1,0,24,0,-24
4127,0,0,252,0,-252
4128,1,0,103,0,-103
4129,1,0,106,0,-106
4130,0,0,30,0,-30
4131,0,0,56,0,-56
4132,0,0,25,0,-25
4133,1,0,17,0,-17
4134,1,1,399,2002,1603
4135,1,1,322,1372,1050
4136,0,0,34,0,-34
4137,1,0,84,0,-84
4138,0,0,6,0,-6
4139,0,0,139,0,-139
4140,1,0,4,0,-4
4141,1,0,61,0,-61
4142,1,0,13,0,-13
4143,1,1,167,1410,1243
4144,1,0,25,0,-25
4145,1,1,1171,1497,326
4146,0,0,17,0,-17
4147,1,1,367,1863,1496
4148,0,0,58,0,-58
4149,1,0,35,0,-35
4150,1,1,695,1642,947
4151,1,1,535,1276,741
4152,1,1,567,1275,708
4153,1,0,5,0,-5
4154,1,0,56,0,-56
4155,0,0,87,0,-87
4156,0,0,67,0,-67
4157,0,0,164,0,-164
4158,0,0,202,0,-202
4159,1,1,1001,1534,533
4160,1,1,222,4133,3911
4161,0,0,47,0,-47
4162,0,0,81,0,-81
4163,0,0,21,0,-21
4164,0,0,83,0,-83
4165,0,0,31,0,-31
4166,1,1,32,1322,1290
4167,1,1,364,1731,1367
4168,0,0,140,0,-140
4169,1,1,204,1298,1094
4170,0,0,62,0,-62
4171,1,0,10,0,-10
4172,1,1,520,1496,976
4173,1,0,36,0,-36
4174,1,1,50,1480,1430
4175,0,0,18,0,-18
4176,0,0,23,0,-23
4177,1,0,2,0,-2
4178,1,1,1086,1343,257
4179,0,0,64,0,-64
4180,0,0,84,0,-84
4181,0,0,35,0,-35
4182,1,1,165,3664,3499
4183,0,0,11,0,-11
4184,1,1,201,1679,1478
4185,0,0,11,0,-11
4186,0,0,14,0,-14
4187,0,0,217,0,-217
4188,0,0,0,0,0
4189,0,0,14,0,-14
4190,1,0,43,0,-43
4191,1,0,39,0,-39
4192,1,0,97,0,-97
4193,0,0,186,0,-186
4194,0,0,13,0,-13
4195,0,0,31,0,-31
4196,1,1,245,1303,1058
4197,1,0,104,0,-104
4198,0,0,0,0,0
4199,1,0,120,0,-120
4200,1,1,289,2872,2583
4201,0,0,31,0,-31
4202,0,0,32,0,-32
4203,0,0,26,0,-26
4204,1,0,57,0,-57
4205,0,0,48,0,-48
4206,0,0,76,0,-76
4207,0,0,1,0,-1
4208,1,0,23,0,-23
4209,1,1,637,1635,998
4210,0,0,15,0,-15
4211,0,0,25,0,-25
4212,0,0,3,0,-3
4213,0,0,134,0,-134
4214,1,1,19,1423,1404
4215,0,0,20,0,-20
4216,1,1,849,1879,1030
4217,1,0,19,0,-19
4218,1,1,385,1248,863
4219,0,0,26,0,-26
4220,1,1,587,1465,878
4221,1,0,32,0,-32
4222,1,1,149,1352,1203
4223,0,0,1,0,-1
4224,1,0,26,0,-26
4225,0,0,0,0,0
4226,1,0,52,0,-52
4227,1,1,416,1405,989
4228,1,1,518,2059,1541
4229,1,0,32,0,-32
4230,1,0,5,0,-5
4231,0,0,50,0,-50
4232,0,0,11,0,-11
4233,0,0,70,0,-70
4234,1,1,728,1585,857
4235,1,1,195,1386,1191
4236,1,0,21,0,-21
4237,0,0,7,0,-7
4238,1,0,49,0,-49
4239,0,0,4,0,-4
4240,1,1,187,1743,1556
4241,1,1,1199,1274,75
4242,0,0,159,0,-159
4243,1,1,1898,1316,-582
4244,1,1,813,1503,690
4245,0,0,33,0,-33
4246,1,1,267,1373,1106
4247,1,0,34,0,-34
4248,1,0,154,0,-154
4249,0,0,49,0,-49
4250,0,0,7,0,-7
4251,1,1,379,1737,1358
4252,0,0,76,0,-76
4253,0,0,38,0,-38
4254,1,1,309,1389,1080
4255,1,1,635,1729,1094
4256,1,1,2227,1996,-231
4257,0,0,171,0,-171
4258,0,0,32,0,-32
4259,1,0,19,0,-19
4260,1,1,343,1308,965
4261,1,1,2001,1555,-446
4262,0,0,59,0,-59
4263,1,1,79,1317,1238
4264,1,1,1339,1373,34
4265,0,0,97,0,-97
4266,0,0,37,0,-37
4267,1,1,295,1258,963
4268,1,0,110,0,-110
4269,0,0,80,0,-80
4270,0,0,21,0,-21
4271,1,0,71,0,-71
4272,1,0,85,0,-85
4273,1,1,566,2090,1524
4274,0,0,145,0,-145
4275,1,1,52,1564,1512
4276,0,0,24,0,-24
4277,1,0,11,0,-11
4278,1,1,415,1497,1082
4279,1,1,996,1441,445
4280,1,1,449,1310,861
4281,1,1,208,3369,3161
4282,1,1,535,1423,888
4283,1,1,747,1360,613
4284,1,1,1195,1425,230
4285,1,1,1124,1236,112
4286,1,1,432,1326,894
4287,1,0,63,0,-63
4288,1,1,402,1433,1031
4289,1,1,1290,1762,472
4290,1,0,33,0,-33
4291,0,0,15,0,-15
4292,0,0,58,0,-58
4293,1,0,5,0,-5
4294,0,0,109,0,-109
4295,1,0,52,0,-52
4296,0,0,16,0,-16
4297,1,1,1090,1487,397
4298,1,1,407,2008,1601
4299,0,0,46,0,-46
4300,1,0,18,0,-18
4301,0,0,19,0,-19
4302,0,0,24,0,-24
4303,1,0,5,0,-5
4304,0,0,50,0,-50
4305,1,1,105,1600,1495
4306,0,0,52,0,-52
4307,1,0,3,0,-3
4308,0,0,33,0,-33
4309,1,1,1147,1827,680
4310,0,0,68,0,-68
4311,1,1,512,1706,1194
4312,1,1,2875,1347,-1528
4313,1,0,30,0,-30
4314,1,0,80,0,-80
4315,1,1,373,2516,2143
4316,1,0,7,0,-7
4317,1,0,5,0,-5
4318,1,1,494,1681,1187
4319,0,0,1,0,-1
4320,1,1,539,1960,1421
4321,0,0,89,0,-89
4322,1,1,1906,1563,-343
4323,0,0,86,0,-86
4324,1,1,123,2350,2227
4325,1,1,348,1457,1109
4326,1,0,18,0,-18
4327,0,0,7,0,-7
4328,0,0,75,0,-75
4329,1,0,12,0,-12
4330,1,1,1622,1313,-309
4331,1,0,35,0,-35
4332,1,1,286,1647,1361
4333,0,0,20,0,-20
4334,1,1,82,2065,1983
4335,0,0,49,0,-49
4336,1,0,23,0,-23
4337,0,0,28,0,-28
4338,0,0,37,0,-37
4339,1,1,59,2440,2381
4340,1,1,1133,2222,1089
4341,1,1,1123,1241,118
4342,1,0,29,0,-29
4343,1,0,69,0,-69
4344,0,0,290,0,-290
4345,1,1,186,1817,1631
4346,0,0,27,0,-27
4347,1,1,395,2798,2403
4348,0,0,29,0,-29
4349,0,0,81,0,-81
4350,0,0,61,0,-61
4351,0,0,7,0,-7
4352,1,1,451,1277,826
4353,0,0,112,0,-112
4354,0,0,3,0,-3
4355,1,1,721,1400,679
4356,1,0,0,0,0
4357,0,0,45,0,-45
4358,1,0,26,0,-26
4359,1,0,59,0,-59
4360,1,0,13,0,-13
4361,1,0,9,0,-9
4362,0,0,135,0,-135
4363,1,1,123,1970,1847
4364,1,0,18,0,-18
4365,0,0,25,0,-25
4366,1,1,174,1449,1275
4367,1,1,513,1577,1064
4368,1,1,959,1732,773
4369,1,0,39,0,-39
4370,0,0,87,0,-87
4371,1,1,625,1402,777
4372,1,1,326,1379,1053
4373,1,0,141,0,-141
4374,1,1,205,1434,1229
4375,0,0,65,0,-65
4376,1,0,87,0,-87
4377,1,0,6,0,-6
4378,0,0,90,0,-90
4379,1,1,789,1399,610
4380,0,0,8,0,-8
4381,1,1,246,1624,1378
4382,1,1,322,1677,1355
4383,1,0,51,0,-51
4384,1,1,543,2057,1514
4385,1,0,277,0,-277
4386,1,0,70,0,-70
4387,0,0,37,0,-37
4388,0,0,5,0,-5
4389,1,0,4,0,-4
4390,0,0,124,0,-124
4391,1,0,5,0,-5
4392,0,0,11,0,-11
4393,0,0,16,0,-16
4394,1,1,396,1752,1356
4395,1,0,53,0,-53
4396,1,0,194,0,-194
4397,1,1,191,1288,1097
4398,1,0,51,0,-51
4399,0,0,176,0,-176
4400,1,0,77,0,-77
4401,1,1,162,1521,1359
4402,0,0,10,0,-10
4403,1,0,15,0,-15
4404,1,0,27,0,-27
4405,1,1,62,1312,1250
4406,1,1,84,2331,2247
4407,1,0,100,0,-100
4408,0,0,38,0,-38
4409,0,0,5,0,-5
4410,1,0,70,0,-70
4411,0,0,24,0,-24
4412,1,1,1128,1237,109
4413,0,0,88,0,-88
4414,0,0,176,0,-176
4415,1,1,157,1719,1562
4416,0,0,0,0,0
4417,1,0,9,0,-9
4418,0,0,15,0,-15
4419,0,0,17,0,-17
4420,0,0,3,0,-3
4421,1,1,1117,1465,348
4422,1,1,870,3880,3010
4423,0,0,83,0,-83
4424,0,0,8,0,-8
4425,1,0,43,0,-43
4426,0,0,7,0,-7
4427,1,0,116,0,-116
4428,1,0,70,0,-70
4429,1,1,885,1572,687
4430,1,1,2967,1560,-1407
4431,0,0,3,0,-3
4432,0,0,23,0,-23
4433,0,0,57,0,-57
4434,0,0,13,0,-13
4435,1,1,121,1803,1682
4436,0,0,30,0,-30
4437,1,0,8,0,-8
4438,0,0,44,0,-44
4439,1,0,117,0,-117
4440,1,0,2,0,-2
4441,1,1,482,1851,1369
4442,1,1,173,1800,1627
4443,1,0,125,0,-125
4444,0,0,40,0,-40
4445,0,0,34,0,-34
4446,0,0,15,0,-15
4447,1,0,90,0,-90
4448,1,0,47,0,-47
4449,0,0,0,0,0
4450,0,0,31,0,-31
4451,0,0,10,0,-10
4452,1,0,23,0,-23
4453,1,1,51,1506,1455
4454,1,1,118,3103,2985
4455,1,1,83,1258,1175
4456,1,1,450,1349,899
4457,0,0,2,0,-2
4458,1,1,293,1498,1205
4459,1,0,29,0,-29
4460,1,0,20,0,-20
4461,1,0,10,0,-10
4462,0,0,23,0,-23
4463,1,0,129,0,-129
4464,1,0,7,0,-7
4465,1,0,6,0,-6
4466,0,0,14,0,-14
4467,1,1,204,1270,1066
4468,0,0,36,0,-36
4469,1,0,64,0,-64
4470,1,1,107,1531,1424
4471,0,0,61,0,-61
4472,0,0,40,0,-40
4473,1,1,1092,1296,204
4474,0,0,180,0,-180
4475,1,1,756,1770,1014
4476,1,1,108,1254,1146
4477,1,1,1108,1409,301
4478,0,0,2,0,-2
4479,0,0,163,0,-163
4480,0,0,58,0,-58
4481,1,1,1143,1848,705
4482,1,1,1778,1318,-460
4483,0,0,8,0,-8
4484,0,0,371,0,-371
4485,1,1,647,1373,726
4486,0,0,67,0,-67
4487,1,1,340,1266,926
4488,1,0,8,0,-8
4489,1,0,27,0,-27
4490,1,0,56,0,-56
4491,1,0,44,0,-44
4492,1,1,2899,1284,-1615
4493,1,1,49,2421,2372
4494,0,0,29,0,-29
4495,0,0,27,0,-27
4496,0,0,46,0,-46
4497,1,1,89,1483,1394
4498,0,0,30,0,-30
4499,0,0,47,0,-47
4500,0,0,38,0,-38
4501,1,0,22,0,-22
4502,0,0,19,0,-19
4503,1,0,36,0,-36
4504,1,0,36,0,-36
4505,0,0,64,0,-64
4506,1,1,278,2107,1829
4507,1,1,962,1256,294
4508,0,0,70,0,-70
4509,1,0,1,0,-1
4510,0,0,0,0,0
4511,1,1,414,1351,937
4512,1,0,47,0,-47
4513,1,1,871,2252,1381
4514,0,0,33,0,-33
4515,0,0,35,0,-35
4516,1,1,321,1622,1301
4517,1,0,37,0,-37
4518,1,0,68,0,-68
4519,0,0,25,0,-25
4520,0,0,3,0,-3
4521,1,0,114,0,-114
4522,1,1,18,1306,1288
4523,1,1,166,1552,1386
4524,0,0,88,0,-88
4525,1,0,44,0,-44
4526,1,1,196,1429,1233
4527,1,0,42,0,-42
4528,0,0,7,0,-7
4529,1,0,205,0,-205
4530,1,1,272,1264,992
4531,1,0,2,0,-2
4532,0,0,6,0,-6
4533,1,0,127,0,-127
4534,1,1,321,1242,921
4535,0,0,9,0,-9
4536,1,0,34,0,-34
4537,0,0,81,0,-81
4538,0,0,55,0,-55
4539,1,1,128,1530,1402
4540,1,1,244,1557,1313
4541,0,0,13,0,-13
4542,0,0,48,0,-48
4543,0,0,16,0,-16
4544,0,0,169,0,-169
4545,0,0,32,0,-32
4546,1,1,2601,1912,-689
4547,1,1,131,1395,1264
4548,1,1,543,1385,842
4549,1,1,523,1498,975
4550,1,0,24,0,-24
4551,0,0,40,0,-40
4552,0,0,23,0,-23
4553,1,1,493,1453,960
4554,0,0,39,0,-39
4555,1,0,19,0,-19
4556,0,0,13,0,-13
4557,1,1,736,1297,561
4558,1,0,43,0,-43
4559,1,1,971,1316,345
4560,0,0,57,0,-57
4561,0,0,51,0,-51
4562,1,0,6,0,-6
4563,1,1,456,1731,1275
4564,1,1,412,1552,1140
4565,0,0,114,0,-114
4566,0,0,16,0,-16
4567,1,0,77,0,-77
4568,1,0,6,0,-6
4569,1,0,121,0,-121
4570,0,0,9,0,-9
4571,1,0,13,0,-13
4572,1,0,21,0,-21
4573,0,0,0,0,0
4574,0,0,99,0,-99
4575,0,0,28,0,-28
4576,1,1,203,1977,1774
4577,1,1,172,2924,2752
4578,1,0,19,0,-19
4579,0,0,56,0,-56
4580,1,1,204,2605,2401
4581,0,0,42,0,-42
4582,0,0,4,0,-4
4583,1,0,20,0,-20
4584,0,0,0,0,0
4585,1,1,222,3220,2998
4586,0,0,71,0,-71
4587,0,0,0,0,0
4588,1,0,87,0,-87
4589,1,1,286,1648,1362
4590,0,0,68,0,-68
4591,0,0,85,0,-85
4592,0,0,48,0,-48
4593,0,0,35,0,-35
4594,0,0,66,0,-66
4595,0,0,1,0,-1
4596,0,0,37,0,-37
4597,1,0,52,0,-52
4598,1,1,1424,1410,-14
4599,0,0,43,0,-43
4600,1,0,20,0,-20
4601,0,0,6,0,-6
4602,1,1,389,2421,2032
4603,1,1,95,1826,1731
4604,0,0,59,0,-59
4605,1,1,281,1411,1130
4606,1,1,699,1514,815
4607,0,0,26,0,-26
4608,1,0,97,0,-97
4609,0,0,147,0,-147
4610,0,0,13,0,-13
4611,0,0,3,0,-3
4612,0,0,111,0,-111
4613,0,0,118,0,-118
4614,1,0,15,0,-15
4615,0,0,67,0,-67
4616,0,0,136,0,-136
4617,0,0,9,0,-9
4618,1,0,1,0,-1
4619,1,1,888,1255,367
4620,1,1,742,1502,760
4621,1,0,24,0,-24
4622,0,0,65,0,-65
4623,0,0,6,0,-6
4624,1,1,932,1492,560
4625,0,0,24,0,-24
4626,1,1,1570,1239,-331
4627,1,0,59,0,-59
4628,1,0,21,0,-21
4629,1,0,34,0,-34
4630,1,1,1476,1516,40
4631,0,0,3,0,-3
4632,0,0,8,0,-8
4633,1,0,112,0,-112
4634,1,1,248,1965,1717
4635,1,0,37,0,-37
4636,1,1,948,1319,371
4637,1,1,1001,1495,494
4638,0,0,81,0,-81
4639,1,1,439,1443,1004
4640,1,0,24,0,-24
4641,1,0,61,0,-61
4642,0,0,12,0,-12
4643,1,1,404,2372,1968
4644,0,0,133,0,-133
4645,0,0,2,0,-2
4646,1,0,8,0,-8
4647,0,0,7,0,-7
4648,0,0,113,0,-113
4649,0,0,31,0,-31
4650,1,0,18,0,-18
4651,0,0,10,0,-10
4652,1,0,34,0,-34
4653,0,0,58,0,-58
4654,0,0,3,0,-3
4655,1,1,505,1523,1018
4656,0,0,19,0,-19
4657,0,0,21,0,-21
4658,0,0,43,0,-43
4659,1,1,2146,1723,-423
4660,0,0,133,0,-133
4661,1,1,40,1647,1607
4662,1,0,112,0,-112
4663,1,1,2181,1284,-897
4664,0,0,10,0,-10
4665,1,1,224,2700,2476
4666,0,0,88,0,-88
4667,0,0,140,0,-140
4668,1,0,32,0,-32
4669,0,0,30,0,-30
4670,1,1,713,1587,874
4671,1,1,1824,1291,-533
4672,1,1,239,1272,1033
4673,1,0,8,0,-8
4674,0,0,7,0,-7
4675,0,0,16,0,-16
4676,1,1,280,1392,1112
4677,0,0,47,0,-47
4678,1,1,246,1565,1319
4679,0,0,15,0,-15
4680,1,1,1665,1390,-275
4681,0,0,22,0,-22
4682,0,0,53,0,-53
4683,1,0,51,0,-51
4684,1,1,333,1864,1531
4685,0,0,27,0,-27
4686,1,1,381,1759,1378
4687,0,0,97,0,-97
4688,0,0,48,0,-48
4689,1,1,1230,1639,409
4690,1,0,56,0,-56
4691,1,1,278,1713,1435
4692,0,0,80,0,-80
4693,1,0,218,0,-218
4694,0,0,111,0,-111
4695,0,0,50,0,-50
4696,1,0,42,0,-42
4697,0,0,34,0,-34
4698,1,1,532,1841,1309
4699,1,0,33,0,-33
4700,1,0,13,0,-13
4701,1,1,2288,2090,-198
4702,1,0,70,0,-70
4703,1,1,1081,2164,1083
4704,1,0,15,0,-15
4705,1,0,12,0,-12
4706,1,0,22,0,-22
4707,1,1,544,1313,769
4708,1,1,566,1671,1105
4709,0,0,46,0,-46
4710,0,0,84,0,-84
4711,0,0,36,0,-36
4712,0,0,3,0,-3
4713,1,1,93,1246,1153
4714,1,1,126,1252,1126
4715,0,0,41,0,-41
4716,1,1,389,2532,2143
4717,1,0,16,0,-16
4718,1,0,1,0,-1
4719,0,0,50,0,-50
4720,1,1,501,1659,1158
4721,1,0,22,0,-22
4722,1,0,68,0,-68
4723,1,0,25,0,-25
4724,1,0,103,0,-103
4725,0,0,2,0,-2
4726,1,1,247,1661,1414
4727,0,0,122,0,-122
4728,0,0,14,0,-14
4729,0,0,5,0,-5
4730,1,0,8,0,-8
4731,0,0,23,0,-23
4732,0,0,106,0,-106
4733,1,0,80,0,-80
4734,1,0,111,0,-111
4735,1,0,35,0,-35
4736,1,0,42,0,-42
4737,1,1,52,1739,1687
4738,1,1,377,1483,1106
4739,1,1,141,1577,1436
4740,1,0,34,0,-34
4741,1,0,107,0,-107
4742,0,0,87,0,-87
4743,1,1,259,1994,1735
4744,0,0,35,0,-35
4745,1,0,28,0,-28
4746,0,0,58,0,-58
4747,0,0,55,0,-55
4748,1,1,835,1611,776
4749,0,0,66,0,-66
4750,0,0,58,0,-58
4751,0,0,49,0,-49
4752,1,0,1,0,-1
4753,0,0,6,0,-6
4754,1,0,11,0,-11
4755,1,1,1356,1356,0
4756,1,0,94,0,-94
4757,1,1,667,2130,1463
4758,0,0,74,0,-74
4759,0,0,83,0,-83
4760,1,0,156,0,-156
4761,0,0,13,0,-13
4762,1,1,1562,1482,-80
4763,1,1,46,1551,1505
4764,0,0,11,0,-11
4765,1,0,142,0,-142
4766,1,0,5,0,-5
4767,0,0,53,0,-53
4768,1,0,20,0,-20
4769,1,1,1213,1259,46
4770,0,0,27,0,-27
4771,1,0,25,0,-25
4772,1,1,2446,2682,236
4773,0,0,15,0,-15
4774,1,1,765,1691,926
4775,0,0,37,0,-37
4776,1,1,682,1325,643
4777,1,0,11,0,-11
4778,0,0,255,0,-255
4779,1,0,46,0,-46
4780,1,0,36,0,-36
4781,1,0,14,0,-14
4782,1,1,742,1341,599
4783,0,0,65,0,-65
4784,0,0,10,0,-10
4785,0,0,18,0,-18
4786,0,0,14,0,-14
4787,1,0,155,0,-155
4788,1,1,205,1404,1199
4789,0,0,46,0,-46
4790,0,0,18,0,-18
4791,0,0,27,0,-27
4792,0,0,41,0,-41
4793,0,0,11,0,-11
4794,0,0,96,0,-96
4795,0,0,36,0,-36
4796,1,0,32,0,-32
4797,0,0,82,0,-82
4798,1,1,367,1342,975
4799,0,0,22,0,-22
4800,1,1,317,1326,1009
4801,1,1,415,1365,950
4802,1,0,3,0,-3
4803,0,0,168,0,-168
4804,1,0,21,0,-21
4805,1,0,96,0,-96
4806,1,1,1356,2888,1532
4807,0,0,8,0,-8
4808,1,0,18,0,-18
4809,0,0,33,0,-33
4810,0,0,28,0,-28
4811,0,0,46,0,-46
4812,1,0,30,0,-30
4813,0,0,168,0,-168
4814,1,0,83,0,-83
4815,0,0,18,0,-18
4816,1,0,2,0,-2
4817,1,0,36,0,-36
4818,1,0,62,0,-62
4819,1,1,806,1436,630
4820,0,0,86,0,-86
4821,0,0,43,0,-43
4822,1,0,14,0,-14
4823,1,0,50,0,-50
4824,0,0,240,0,-240
4825,1,1,257,2211,1954
4826,1,0,35,0,-35
4827,1,0,0,0,0
4828,1,0,48,0,-48
4829,0,0,109,0,-109
4830,0,0,12,0,-12
4831,1,0,6,0,-6
4832,1,0,55,0,-55
4833,1,0,93,0,-93
4834,0,0,48,0,-48
4835,1,1,456,1316,860
4836,0,0,46,0,-46
4837,1,1,258,1442,1184
4838,1,1,1779,2028,249
4839,1,1,316,2151,1835
4840,1,1,268,1768,1500
4841,1,0,27,0,-27
4842,1,0,50,0,-50
4843,1,1,55,1608,1553
4844,1,0,228,0,-228
4845,0,0,3,0,-3
4846,0,0,6,0,-6
4847,1,1,1027,1281,254
4848,0,0,192,0,-192
4849,1,1,364,1501,1137
4850,1,0,3,0,-3
4851,1,0,43,0,-43
4852,0,0,97,0,-97
4853,0,0,9,0,-9
4854,1,0,70,0,-70
4855,1,1,312,1382,1070
4856,0,0,30,0,-30
4857,0,0,82,0,-82
4858,1,0,98,0,-98
4859,1,0,64,0,-64
4860,1,1,236,1591,1355
4861,0,0,45,0,-45
4862,1,1,285,2218,1933
4863,1,0,65,0,-65
4864,1,1,692,1934,1242
4865,1,0,47,0,-47
4866,1,1,95,1272,1177
4867,0,0,6,0,-6
4868,1,1,238,1297,1059
4869,1,1,134,1341,1207
4870,0,0,30,0,-30
4871,0,0,66,0,-66
4872,1,0,21,0,-21
4873,1,1,620,1938,1318
4874,1,1,536,1338,802
4875,1,1,288,1300,1012
4876,1,0,23,0,-23
4877,1,0,291,0,-291
4878,1,1,158,1460,1302
4879,1,1,463,1601,1138
4880,1,0,23,0,-23
4881,1,1,53,1249,1196
4882,0,0,101,0,-101
4883,0,0,6,0,-6
4884,0,0,146,0,-146
4885,1,1,543,1444,901
4886,1,1,224,1327,1103
4887,1,0,46,0,-46
4888,0,0,0,0,0
4889,1,0,26,0,-26
4890,0,0,6,0,-6
4891,1,0,217,0,-217
4892,0,0,8,0,-8
4893,0,0,1,0,-1
4894,1,1,577,1578,1001
4895,0,0,125,0,-125
4896,1,1,142,1494,1352
4897,0,0,22,0,-22
4898,0,0,27,0,-27
4899,1,1,174,1320,1146
4900,0,0,39,0,-39
4901,1,1,160,1434,1274
4902,0,0,13,0,-13
4903,1,1,118,1396,1278
4904,1,1,549,1435,886
4905,1,1,171,2218,2047
4906,0,0,24,0,-24
4907,1,1,399,1247,848
4908,0,0,21,0,-21
4909,1,1,273,2111,1838
4910,1,0,58,0,-58
4911,1,1,1264,1261,-3
4912,1,1,130,2234,2104
4913,1,0,96,0,-96
4914,1,0,43,0,-43
4915,0,0,10,0,-10
4916,1,0,70,0,-70
4917,1,0,62,0,-62
4918,1,1,1369,2362,993
4919,0,0,14,0,-14
4920,1,0,10,0,-10
4921,1,1,570,1481,911
4922,1,1,369,2665,2296
4923,1,1,50,1369,1319
4924,0,0,18,0,-18
4925,1,0,63,0,-63
4926,0,0,2,0,-2
4927,0,0,210,0,-210
4928,0,0,10,0,-10
4929,0,0,136,0,-136
4930,1,0,1,0,-1
4931,0,0,12,0,-12
4932,1,1,1644,1336,-308
4933,0,0,219,0,-219
4934,1,0,22,0,-22
4935,1,1,112,1531,1419
4936,1,0,7,0,-7
4937,0,0,20,0,-20
4938,1,1,158,1719,1561
4939,1,0,142,0,-142
4940,0,0,25,0,-25
4941,1,0,114,0,-114
4942,1,1,3589,1272,-2317
4943,0,0,108,0,-108
4944,0,0,22,0,-22
4945,1,0,184,0,-184
4946,1,1,1046,1245,199
4947,1,0,12,0,-12
4948,1,0,1,0,-1
4949,1,1,856,3270,2414
4950,1,1,520,1717,1197
4951,1,1,212,1387,1175
4952,1,1,621,1354,733
4953,1,1,157,1582,1425
4954,0,0,36,0,-36
4955,0,0,17,0,-17
4956,0,0,41,0,-41
4957,0,0,81,0,-81
4958,0,0,78,0,-78
4959,1,0,59,0,-59
4960,0,0,96,0,-96
4961,1,1,452,1507,1055
4962,1,0,20,0,-20
4963,0,0,12,0,-12
4964,1,1,648,1264,616
4965,0,0,2,0,-2
4966,1,0,33,0,-33
4967,0,0,63,0,-63
4968,1,1,731,1315,584
4969,0,0,62,0,-62
4970,1,0,64,0,-64
4971,1,0,238,0,-238
4972,1,1,707,3422,2715
4973,0,0,7,0,-7
4974,0,0,316,0,-316
4975,1,1,606,1381,775
4976,1,0,30,0,-30
4977,0,0,100,0,-100
4978,1,1,806,1284,478
4979,1,1,565,1705,1140
4980,1,1,684,1476,792
4981,1,1,1216,1271,55
4982,1,0,12,0,-12
4983,0,0,23,0,-23
4984,1,1,151,1344,1193
4985,0,0,48,0,-48
4986,0,0,59,0,-59
4987,1,1,2952,1500,-1452
4988,0,0,53,0,-53
4989,0,0,114,0,-114
4990,0,0,29,0,-29
4991,1,0,20,0,-20
4992,1,0,44,0,-44
4993,1,1,1300,1380,80
4994,0,0,35,0,-35
4995,1,0,19,0,-19
4996,1,0,10,0,-10
4997,1,0,9,0,-9
4998,1,1,86,1581,1495
4999,0,0,19,0,-19
5000,1,1,638,1447,809
5001,1,0,154,0,-154
5002,1,0,4,0,-4
5003,1,1,646,1296,650
5004,1,1,65,1523,1458
5005,0,0,77,0,-77
5006,0,0,81,0,-81
5007,0,0,49,0,-49
5008,0,0,14,0,-14
5009,0,0,51,0,-51
5010,1,0,23,0,-23
5011,1,0,42,0,-42
5012,1,1,1111,1237,126
5013,1,0,94,0,-94
5014,1,1,285,1399,1114
5015,0,0,4,0,-4
5016,1,1,363,1406,1043
5017,0,0,33,0,-33
5018,1,1,79,1272,1193
5019,0,0,7,0,-7
5020,1,1,625,1600,975
5021,0,0,123,0,-123
5022,1,0,16,0,-16
5023,0,0,62,0,-62
5024,1,1,782,1277,495
5025,1,1,157,1873,1716
5026,1,0,18,0,-18
5027,1,0,6,0,-6
5028,0,0,1,0,-1
5029,1,0,21,0,-21
5030,0,0,124,0,-124
5031,1,0,56,0,-56
5032,1,0,60,0,-60
5033,1,0,83,0,-83
5034,1,0,3,0,-3
5035,1,1,75,1401,1326
5036,0,0,33,0,-33
5037,1,1,14,2382,2368
5038,0,0,61,0,-61
5039,1,0,40,0,-40
5040,1,1,1697,1355,-342
5041,1,1,402,1360,958
5042,0,0,28,0,-28
5043,1,1,2142,1668,-474
5044,1,0,25,0,-25
5045,1,0,58,0,-58
5046,0,0,1,0,-1
5047,1,0,11,0,-11
5048,0,0,49,0,-49
5049,0,0,12,0,-12
5050,1,1,546,1897,1351
5051,1,0,10,0,-10
5052,1,1,879,1449,570
5053,0,0,8,0,-8
5054,1,1,2377,1651,-726
5055,1,0,98,0,-98
5056,1,0,15,0,-15
5057,1,1,1359,1242,-117
5058,0,0,14,0,-14
5059,0,0,25,0,-25
5060,1,0,52,0,-52
5061,1,0,25,0,-25
5062,1,0,78,0,-78
5063,1,1,538,1393,855
5064,1,1,404,1252,848
5065,1,1,400,1353,953
5066,0,0,26,0,-26
5067,0,0,211,0,-211
5068,0,0,65,0,-65
5069,0,0,24,0,-24
5070,0,0,8,0,-8
5071,0,0,46,0,-46
5072,0,0,45,0,-45
5073,1,0,66,0,-66
5074,0,0,0,0,0
5075,1,0,9,0,-9
5076,1,1,1231,2367,1136
5077,0,0,62,0,-62
5078,1,0,7,0,-7
5079,0,0,2,0,-2
5080,1,0,4,0,-4
5081,1,0,26,0,-26
5082,1,0,6,0,-6
5083,0,0,57,0,-57
5084,1,1,934,3835,2901
5085,0,0,131,0,-131
5086,0,0,74,0,-74
5087,1,0,78,0,-78
5088,1,0,24,0,-24
5089,1,0,19,0,-19
5090,1,1,177,1381,1204
5091,0,0,22,0,-22
5092,1,0,3,0,-3
5093,1,1,1227,2528,1301
5094,1,1,42,1912,1870
5095,1,1,107,1515,1408
5096,1,0,24,0,-24
5097,1,0,26,0,-26
5098,1,1,218,1283,1065
5099,0,0,19,0,-19
5100,1,0,15,0,-15
5101,1,0,21,0,-21
5102,1,1,317,1722,1405
5103,1,1,343,1361,1018
5104,1,0,29,0,-29
5105,0,0,186,0,-186
5106,1,1,177,2076,1899
5107,1,0,30,0,-30
5108,0,0,13,0,-13
5109,0,0,37,0,-37
5110,1,1,192,1385,1193
5111,0,0,44,0,-44
5112,1,0,83,0,-83
5113,0,0,18,0,-18
5114,1,0,24,0,-24
5115,0,0,116,0,-116
5116,1,1,432,1505,1073
5117,1,1,646,1361,715
5118,0,0,16,0,-16
5119,1,1,1421,1359,-62
5120,0,0,25,0,-25
5121,0,0,55,0,-55
5122,1,1,296,1619,1323
5123,0,0,84,0,-84
5124,0,0,59,0,-59
5125,0,0,22,0,-22
5126,0,0,21,0,-21
5127,1,1,1372,1795,423
5128,1,1,61,1940,1879
5129,0,0,3,0,-3
5130,1,0,95,0,-95
5131,0,0,61,0,-61
5132,1,0,135,0,-135
5133,1,0,142,0,-142
5134,1,1,334,1347,1013
5135,0,0,98,0,-98
5136,1,1,432,1408,976
5137,1,0,10,0,-10
5138,0,0,21,0,-21
5139,1,0,107,0,-107
5140,1,0,13,0,-13
5141,0,0,31,0,-31
5142,1,1,981,1327,346
5143,1,1,440,1263,823
5144,1,1,69,2218,2149
5145,1,1,607,1559,952
5146,1,0,20,0,-20
5147,1,1,609,1802,1193
5148,1,1,648,1925,1277
5149,1,0,20,0,-20
5150,1,1,2088,1334,-754
5151,0,0,15,0,-15
5152,0,0,10,0,-10
5153,1,0,34,0,-34
5154,1,1,251,1439,1188
5155,0,0,31,0,-31
5156,0,0,40,0,-40
5157,0,0,8,0,-8
5158,0,0,65,0,-65
5159,0,0,44,0,-44
5160,1,0,2,0,-2
5161,1,0,17,0,-17
5162,0,0,12,0,-12
5163,1,1,706,1473,767
5164,1,0,14,0,-14
5165,0,0,11,0,-11
5166,1,1,915,1266,351
5167,0,0,6,0,-6
5168,0,0,90,0,-90
5169,1,0,69,0,-69
5170,0,0,7,0,-7
5171,0,0,118,0,-118
5172,1,1,241,1811,1570
5173,1,0,22,0,-22
5174,1,1,1182,1473,291
5175,0,0,6,0,-6
5176,0,0,96,0,-96
5177,1,1,164,1581,1417
5178,1,1,30,1320,1290
5179,1,1,526,2027,1501
5180,0,0,65,0,-65
5181,1,0,69,0,-69
5182,1,0,106,0,-106
5183,0,0,0,0,0
5184,1,1,573,1566,993
5185,1,1,104,1355,1251
5186,1,0,1,0,-1
5187,1,1,126,1733,1607
5188,0,0,124,0,-124
5189,1,0,14,0,-14
5190,1,1,79,1378,1299
5191,1,1,171,3032,2861
5192,1,1,111,1420,1309
5193,1,0,17,0,-17
5194,1,0,112,0,-112
5195,0,0,9,0,-9
5196,0,0,22,0,-22
5197,1,1,211,2009,1798
5198,0,0,15,0,-15
5199,1,1,574,2095,1521
5200,1,1,641,1809,1168
5201,0,0,36,0,-36
5202,0,0,26,0,-26
5203,0,0,200,0,-200
5204,0,0,29,0,-29
5205,0,0,0,0,0
5206,1,1,428,1908,1480
5207,1,0,74,0,-74
5208,1,0,20,0,-20
5209,0,0,2,0,-2
5210,0,0,24,0,-24
5211,1,0,60,0,-60
5212,1,1,113,1330,1217
5213,0,0,31,0,-31
5214,1,1,426,1284,858
5215,1,1,377,1515,1138
5216,0,0,25,0,-25
5217,1,0,1,0,-1
5218,1,0,46,0,-46
5219,1,1,197,1652,1455
5220,1,1,558,1283,725
5221,0,0,75,0,-75
5222,1,0,39,0,-39
5223,1,1,346,1706,1360
5224,0,0,25,0,-25
5225,0,0,3,0,-3
5226,0,0,6,0,-6
5227,0,0,86,0,-86
5228,1,0,19,0,-19
5229,0,0,91,0,-91
5230,0,0,20,0,-20
5231,1,1,589,1320,731
5232,0,0,9,0,-9
5233,1,0,74,0,-74
5234,1,1,347,1416,1069
5235,0,0,18,0,-18
5236,1,1,15,1401,1386
5237,0,0,53,0,-53
5238,1,1,151,1245,1094
5239,0,0,42,0,-42
5240,1,0,6,0,-6
5241,0,0,9,0,-9
5242,0,0,60,0,-60
5243,0,0,1,0,-1
5244,1,0,37,0,-37
5245,1,0,66,0,-66
5246,0,0,12,0,-12
5247,0,0,5,0,-5
5248,1,1,664,1814,1150
5249,1,1,284,1301,1017
5250,0,0,2,0,-2
5251,1,1,1385,1275,-110
5252,0,0,17,0,-17
5253,1,1,358,1561,1203
5254,0,0,228,0,-228
5255,1,0,15,0,-15
5256,0,0,21,0,-21
5257,1,1,414,1319,905
5258,1,1,425,1390,965
5259,1,0,11,0,-11
5260,1,1,77,1400,1323
5261,1,0,41,0,-41
5262,1,0,188,0,-188
5263,1,0,104,0,-104
5264,0,0,119,0,-119
5265,1,0,3,0,-3
5266,1,0,49,0,-49
5267,1,0,19,0,-19
5268,1,0,50,0,-50
5269,1,1,377,1366,989
5270,1,1,712,1253,541
5271,1,0,51,0,-51
5272,1,1,208,1813,1605
5273,0,0,59,0,-59
5274,1,0,59,0,-59
5275,0,0,12,0,-12
5276,1,0,8,0,-8
5277,0,0,14,0,-14
5278,0,0,35,0,-35
5279,1,0,1,0,-1
5280,0,0,22,0,-22
5281,0,0,29,0,-29
5282,1,0,256,0,-256
5283,1,0,9,0,-9
5284,1,1,342,1582,1240
5285,0,0,59,0,-59
5286,1,1,268,1240,972
5287,0,0,162,0,-162
5288,1,1,354,1840,1486
5289,1,1,503,1992,1489
5290,0,0,103,0,-103
5291,1,1,293,2553,2260
5292,1,0,2,0,-2
5293,1,1,1723,1392,-331
5294,0,0,10,0,-10
5295,0,0,5,0,-5
5296,0,0,47,0,-47
5297,0,0,9,0,-9
5298,0,0,16,0,-16
5299,1,1,218,1558,1340
5300,0,0,206,0,-206
5301,0,0,25,0,-25
5302,0,0,18,0,-18
5303,0,0,60,0,-60
5304,0,0,57,0,-57
5305,1,1,364,1409,1045
5306,1,0,22,0,-22
5307,1,0,68,0,-68
5308,0,0,25,0,-25
5309,0,0,63,0,-63
5310,0,0,26,0,-26
5311,0,0,125,0,-125
5312,1,0,25,0,-25
5313,1,1,285,1336,1051
5314,1,0,20,0,-20
5315,1,0,3,0,-3
5316,1,1,256,1332,1076
5317,0,0,8,0,-8
5318,0,0,101,0,-101
5319,1,0,142,0,-142
5320,1,1,530,1573,1043
5321,1,0,51,0,-51
5322,1,1,436,1411,975
5323,0,0,18,0,-18
5324,0,0,3,0,-3
5325,1,1,345,1244,899
5326,1,1,95,3331,3236
5327,0,0,37,0,-37
5328,1,0,4,0,-4
5329,1,0,87,0,-87
5330,1,1,439,1339,900
5331,1,0,61,0,-61
5332,0,0,10,0,-10
5333,0,0,60,0,-60
5334,1,1,2836,1401,-1435
5335,1,0,63,0,-63
5336,1,1,529,1526,997
5337,1,0,18,0,-18
5338,0,0,46,0,-46
5339,1,1,352,1868,1516
5340,0,0,90,0,-90
5341,1,1,760,2220,1460
5342,0,0,20,0,-20
5343,0,0,15,0,-15
5344,1,1,372,1854,1482
5345,1,0,1,0,-1
5346,1,0,7,0,-7
5347,0,0,73,0,-73
5348,0,0,45,0,-45
5349,1,1,489,2614,2125
5350,1,0,44,0,-44
5351,1,1,70,1790,1720
5352,1,1,501,1371,870
5353,0,0,62,0,-62
5354,0,0,32,0,-32
5355,0,0,50,0,-50
5356,0,0,10,0,-10
5357,0,0,79,0,-79
5358,1,1,365,1793,1428
5359,1,1,248,1726,1478
5360,1,1,99,1373,1274
5361,0,0,24,0,-24
5362,1,0,44,0,-44
5363,0,0,3,0,-3
5364,1,1,51,1262,1211
5365,1,0,10,0,-10
5366,0,0,78,0,-78
5367,0,0,24,0,-24
5368,1,1,297,1725,1428
5369,1,1,295,1320,1025
5370,1,1,621,3191,2570
5371,1,0,24,0,-24
5372,1,0,81,0,-81
5373,0,0,26,0,-26
5374,1,1,771,1478,707
5375,1,1,901,1333,432
5376,0,0,3,0,-3
5377,1,0,46,0,-46
5378,1,0,28,0,-28
5379,1,1,638,2068,1430
5380,1,1,199,2779,2580
5381,0,0,23,0,-23
5382,1,1,501,3059,2558
5383,0,0,23,0,-23
5384,1,1,37,1539,1502
5385,0,0,11,0,-11
5386,1,0,178,0,-178
5387,1,0,30,0,-30
5388,1,1,807,1303,496
5389,1,1,152,1518,1366
5390,1,0,80,0,-80
5391,0,0,53,0,-53
5392,1,1,1062,2397,1335
5393,1,0,47,0,-47
5394,1,1,793,1892,1099
5395,0,0,12,0,-12
5396,1,0,39,0,-39
5397,0,0,41,0,-41
5398,1,0,167,0,-167
5399,1,1,603,2460,1857
5400,1,1,93,1386,1293
5401,1,0,2,0,-2
5402,1,1,91,1382,1291
5403,0,0,93,0,-93
5404,1,0,57,0,-57
5405,1,0,18,0,-18
5406,0,0,26,0,-26
5407,0,0,18,0,-18
5408,0,0,42,0,-42
5409,0,0,43,0,-43
5410,1,1,212,1868,1656
5411,1,1,807,1458,651
5412,0,0,26,0,-26
5413,0,0,42,0,-42
5414,0,0,68,0,-68
5415,1,1,1679,1236,-443
5416,1,1,313,1754,1441
5417,0,0,28,0,-28
5418,0,0,6,0,-6
5419,0,0,21,0,-21
5420,0,0,138,0,-138
5421,1,1,665,1772,1107
5422,0,0,191,0,-191
5423,0,0,9,0,-9
5424,1,1,456,1301,845
5425,1,0,10,0,-10
5426,1,1,171,1566,1395
5427,0,0,62,0,-62
5428,0,0,10,0,-10
5429,1,0,0,0,0
5430,1,1,301,1397,1096
5431,1,1,1375,1409,34
5432,0,0,25,0,-25
5433,1,0,21,0,-21
5434,1,0,43,0,-43
5435,0,0,70,0,-70
5436,1,0,58,0,-58
5437,1,1,157,3754,3597
5438,1,0,80,0,-80
5439,1,0,55,0,-55
5440,1,0,43,0,-43
5441,1,1,824,1573,749
5442,0,0,18,0,-18
5443,1,1,647,1242,595
5444,1,1,175,1338,1163
5445,0,0,129,0,-129
5446,1,0,17,0,-17
5447,0,0,18,0,-18
5448,0,0,20,0,-20
5449,1,1,900,5485,4585
5450,0,0,74,0,-74
5451,0,0,9,0,-9
5452,0,0,26,0,-26
5453,0,0,81,0,-81
5454,0,0,30,0,-30
5455,0,0,33,0,-33
5456,0,0,6,0,-6
5457,0,0,18,0,-18
5458,1,0,23,0,-23
5459,0,0,0,0,0
5460,0,0,50,0,-50
5461,1,1,1907,2171,264
5462,1,1,729,1315,586
5463,1,1,815,1753,938
5464,0,0,44,0,-44
5465,1,0,64,0,-64
5466,1,1,129,1561,1432
5467,0,0,1,0,-1
5468,0,0,2,0,-2
5469,1,1,144,1391,1247
5470,1,0,112,0,-112
5471,0,0,68,0,-68
5472,1,0,20,0,-20
5473,1,1,1234,1329,95
5474,1,0,11,0,-11
5475,1,1,211,2894,2683
5476,0,0,15,0,-15
5477,1,1,268,1283,1015
5478,0,0,44,0,-44
5479,0,0,103,0,-103
5480,1,1,180,1712,1532
5481,1,0,26,0,-26
5482,1,1,193,1903,1710
5483,0,0,30,0,-30
5484,1,1,1341,1463,122
5485,0,0,7,0,-7
5486,0,0,0,0,0
5487,0,0,128,0,-128
5488,0,0,1,0,-1
5489,0,0,29,0,-29
5490,1,1,366,1337,971
5491,0,0,57,0,-57
5492,0,0,35,0,-35
5493,1,1,711,1534,823
5494,0,0,0,0,0
5495,0,0,76,0,-76
5496,0,0,30,0,-30
5497,1,0,28,0,-28
5498,1,0,55,0,-55
5499,1,0,95,0,-95
5500,0,0,14,0,-14
5501,0,0,181,0,-181
5502,0,0,70,0,-70
5503,0,0,31,0,-31
5504,1,0,22,0,-22
5505,1,0,23,0,-23
5506,0,0,7,0,-7
5507,0,0,10,0,-10
5508,1,1,543,2784,2241
5509,1,1,416,1322,906
5510,1,0,46,0,-46
5511,0,0,102,0,-102
5512,0,0,21,0,-21
5513,1,1,756,1837,1081
5514,0,0,13,0,-13
5515,1,0,50,0,-50
5516,0,0,1,0,-1
5517,1,0,39,0,-39
5518,0,0,4,0,-4
5519,1,1,471,1501,1030
5520,0,0,56,0,-56
5521,1,1,632,1392,760
5522,1,1,890,1246,356
5523,0,0,68,0,-68
5524,0,0,52,0,-52
5525,1,1,718,2543,1825
5526,0,0,3,0,-3
5527,1,0,44,0,-44
5528,1,0,10,0,-10
5529,0,0,1,0,-1
5530,1,0,69,0,-69
5531,0,0,57,0,-57
5532,0,0,19,0,-19
5533,1,1,95,2020,1925
5534,1,0,0,0,0
5535,1,0,33,0,-33
5536,1,0,19,0,-19
5537,1,1,267,1259,992
5538,0,0,29,0,-29
5539,1,0,32,0,-32
5540,0,0,52,0,-52
5541,0,0,38,0,-38
5542,0,0,11,0,-11
5543,1,0,46,0,-46
5544,1,1,656,1446,790
5545,0,0,0,0,0
5546,1,0,18,0,-18
5547,0,0,3,0,-3
5548,0,0,4,0,-4
5549,0,0,21,0,-21
5550,0,0,210,0,-210
5551,1,1,704,1321,617
5552,1,1,608,1382,774
5553,0,0,38,0,-38
5554,0,0,72,0,-72
5555,0,0,20,0,-20
5556,0,0,7,0,-7
5557,1,0,32,0,-32
5558,0,0,11,0,-11
5559,1,1,458,2077,1619
5560,1,0,3,0,-3
5561,1,1,427,3586,3159
5562,1,0,52,0,-52
5563,1,0,11,0,-11
5564,0,0,10,0,-10
5565,0,0,9,0,-9
5566,1,1,62,1517,1455
5567,1,0,7,0,-7
5568,1,1,1549,1433,-116
5569,0,0,23,0,-23
5570,1,1,1424,1561,137
5571,0,0,31,0,-31
5572,0,0,38,0,-38
5573,1,1,228,3020,2792
5574,1,0,16,0,-16
5575,1,0,1,0,-1
5576,1,0,75,0,-75
5577,1,1,822,1988,1166
5578,1,1,53,1236,1183
5579,1,0,18,0,-18
5580,0,0,8,0,-8
5581,1,0,5,0,-5
5582,1,0,92,0,-92
5583,1,0,35,0,-35
5584,1,1,204,1896,1692
5585,1,1,591,1337,746
5586,0,0,14,0,-14
5587,1,0,2,0,-2
5588,0,0,53,0,-53
5589,1,0,13,0,-13
5590,0,0,22,0,-22
5591,1,1,100,1547,1447
5592,1,1,97,1252,1155
5593,1,1,521,1289,768
5594,0,0,13,0,-13
5595,0,0,11,0,-11
5596,0,0,45,0,-45
5597,1,1,697,1733,1036
5598,0,0,39,0,-39
5599,0,0,18,0,-18
5600,1,1,916,1655,739
5601,1,1,299,1514,1215
5602,1,1,2054,1389,-665
5603,1,1,55,1426,1371
5604,1,1,235,1469,1234
5605,0,0,13,0,-13
5606,1,0,40,0,-40
5607,0,0,19,0,-19
5608,1,1,489,1542,1053
5609,1,0,156,0,-156
5610,1,1,313,1283,970
5611,1,1,157,1478,1321
5612,1,1,743,1312,569
5613,0,0,15,0,-15
5614,1,1,1100,1397,297
5615,1,1,31,1867,1836
5616,1,1,887,1722,835
5617,1,0,41,0,-41
5618,0,0,18,0,-18
5619,1,0,35,0,-35
5620,0,0,17,0,-17
5621,1,0,5,0,-5
5622,0,0,57,0,-57
5623,1,1,1272,1660,388
5624,0,0,74,0,-74
5625,1,0,61,0,-61
5626,0,0,85,0,-85
5627,1,1,37,1271,1234
5628,1,0,55,0,-55
5629,1,0,65,0,-65
5630,1,1,279,1710,1431
5631,0,0,49,0,-49
5632,0,0,27,0,-27
5633,0,0,42,0,-42
5634,1,0,7,0,-7
5635,1,0,104,0,-104
5636,1,0,1,0,-1
5637,0,0,33,0,-33
5638,1,0,1,0,-1
5639,1,1,1436,2840,1404
5640,1,0,2,0,-2
5641,1,1,723,1694,971
5642,1,1,86,1469,1383
5643,0,0,58,0,-58
5644,0,0,8,0,-8
5645,0,0,70,0,-70
5646,1,0,175,0,-175
5647,0,0,30,0,-30
5648,0,0,31,0,-31
5649,0,0,283,0,-283
5650,1,1,190,1658,1468
5651,1,1,247,1829,1582
5652,1,0,10,0,-10
5653,0,0,115,0,-115
5654,1,1,70,1812,1742
5655,1,0,80,0,-80
5656,0,0,0,0,0
5657,0,0,23,0,-23
5658,0,0,268,0,-268
5659,0,0,60,0,-60
5660,0,0,161,0,-161
5661,1,1,120,1899,1779
5662,1,0,34,0,-34
5663,1,1,708,1459,751
5664,1,1,140,1448,1308
5665,1,0,25,0,-25
5666,1,1,130,1561,1431
5667,1,0,10,0,-10
5668,1,0,31,0,-31
5669,0,0,27,0,-27
5670,1,0,28,0,-28
5671,1,0,169,0,-169
5672,0,0,60,0,-60
5673,1,1,462,1306,844
5674,0,0,58,0,-58
5675,0,0,38,0,-38
5676,0,0,11,0,-11
5677,1,1,578,2623,2045
5678,1,0,60,0,-60
5679,1,0,76,0,-76
5680,1,0,53,0,-53
5681,1,0,136,0,-136
5682,1,0,67,0,-67
5683,1,1,258,2262,2004
5684,1,1,489,1644,1155
5685,0,0,50,0,-50
5686,1,0,6,0,-6
5687,0,0,42,0,-42
5688,1,0,26,0,-26
5689,1,1,1441,1236,-205
5690,1,0,7,0,-7
5691,1,0,109,0,-109
5692,1,1,208,1309,1101
5693,1,0,27,0,-27
5694,1,1,80,1551,1471
5695,1,1,242,1791,1549
5696,1,0,25,0,-25
5697,1,0,208,0,-208
5698,0,0,18,0,-18
5699,1,1,31,4254,4223
5700,1,1,977,1321,344
5701,1,1,904,1245,341
5702,1,1,60,1542,1482
5703,1,0,9,0,-9
5704,0,0,7,0,-7
5705,1,1,1004,1601,597
5706,1,0,155,0,-155
5707,1,0,80,0,-80
5708,1,0,1,0,-1
5709,1,1,478,1247,769
5710,1,1,350,1398,1048
5711,0,0,59,0,-59
5712,1,1,477,1886,1409
5713,0,0,82,0,-82
5714,1,1,212,4092,3880
5715,0,0,2,0,-2
5716,0,0,1,0,-1
5717,1,1,803,1405,602
5718,1,1,323,1335,1012
5719,1,1,249,1842,1593
5720,0,0,40,0,-40
5721,1,1,151,1397,1246
5722,0,0,4,0,-4
5723,1,1,415,1758,1343
5724,0,0,37,0,-37
5725,1,1,477,2314,1837
5726,0,0,31,0,-31
5727,1,0,17,0,-17
5728,1,1,410,1401,991
5729,1,0,60,0,-60
5730,1,0,95,0,-95
5731,0,0,32,0,-32
5732,0,0,72,0,-72
5733,1,1,596,1644,1048
5734,0,0,16,0,-16
5735,1,1,763,2074,1311
5736,1,0,19,0,-19
5737,1,0,79,0,-79
5738,0,0,12,0,-12
5739,0,0,11,0,-11
5740,1,0,105,0,-105
5741,1,0,11,0,-11
5742,1,0,5,0,-5
5743,1,0,38,0,-38
5744,0,0,26,0,-26
5745,0,0,139,0,-139
5746,1,1,566,1607,1041
5747,1,1,1428,2615,1187
5748,0,0,12,0,-12
5749,0,0,57,0,-57
5750,0,0,33,0,-33
5751,1,0,7,0,-7
5752,1,1,1871,1797,-74
5753,1,1,65,2431,2366
5754,0,0,39,0,-39
5755,1,1,563,1383,820
5756,1,0,21,0,-21
5757,1,1,2057,1241,-816
5758,1,0,99,0,-99
5759,0,0,76,0,-76
5760,1,0,94,0,-94
5761,1,1,797,2342,1545
5762,1,1,170,1358,1188
5763,0,0,46,0,-46
5764,0,0,30,0,-30
5765,1,1,1916,1759,-157
5766,1,1,506,1526,1020
5767,1,0,118,0,-118
5768,0,0,126,0,-126
5769,1,0,10,0,-10
5770,1,0,76,0,-76
5771,1,1,818,1279,461
5772,0,0,6,0,-6
5773,1,1,1024,1343,319
5774,0,0,55,0,-55
5775,0,0,10,0,-10
5776,0,0,270,0,-270
5777,0,0,14,0,-14
5778,1,0,3,0,-3
5779,1,0,0,0,0
5780,0,0,18,0,-18
5781,0,0,14,0,-14
5782,1,0,104,0,-104
5783,1,1,72,1455,1383
5784,1,1,480,2665,2185
5785,1,0,2,0,-2
5786,0,0,75,0,-75
5787,0,0,5,0,-5
5788,1,0,43,0,-43
5789,1,1,111,1325,1214
5790,1,1,269,1346,1077
5791,1,1,279,1241,962
5792,0,0,79,0,-79
5793,1,0,51,0,-51
5794,1,0,13,0,-13
5795,0,0,5,0,-5
5796,1,0,30,0,-30
5797,0,0,47,0,-47
5798,1,0,80,0,-80
5799,1,0,31,0,-31
5800,1,1,450,1253,803
5801,1,0,23,0,-23
5802,1,1,533,1295,762
5803,0,0,7,0,-7
5804,1,0,1,0,-1
5805,1,1,469,1442,973
5806,0,0,9,0,-9
5807,0,0,52,0,-52
5808,0,0,2,0,-2
5809,1,1,327,1889,1562
5810,1,1,656,1340,684
5811,1,1,139,1693,1554
5812,1,0,8,0,-8
5813,0,0,105,0,-105
5814,0,0,18,0,-18
5815,1,0,22,0,-22
5816,1,1,78,1502,1424
5817,1,0,11,0,-11
5818,0,0,8,0,-8
5819,0,0,5,0,-5
5820,0,0,59,0,-59
5821,1,0,28,0,-28
5822,0,0,83,0,-83
5823,0,0,50,0,-50
5824,1,0,28,0,-28
5825,0,0,25,0,-25
5826,0,0,77,0,-77
5827,0,0,30,0,-30
5828,0,0,29,0,-29
5829,1,0,107,0,-107
5830,0,0,59,0,-59
5831,1,1,505,1725,1220
5832,1,1,558,1502,944
5833,0,0,10,0,-10
5834,1,1,519,1553,1034
5835,1,0,21,0,-21
5836,1,0,42,0,-42
5837,0,0,17,0,-17
5838,0,0,68,0,-68
5839,1,1,40,1293,1253
5840,1,1,940,1235,295
5841,1,0,14,0,-14
5842,1,1,162,1329,1167
5843,1,1,347,2479,2132
5844,1,0,26,0,-26
5845,1,0,24,0,-24
5846,1,1,369,1759,1390
5847,1,1,152,3773,3621
5848,1,1,141,1542,1401
5849,1,0,7,0,-7
5850,1,1,348,1587,1239
5851,1,0,16,0,-16
5852,0,0,104,0,-104
5853,0,0,55,0,-55
5854,1,1,298,1391,1093
5855,0,0,45,0,-45
5856,0,0,12,0,-12
5857,0,0,119,0,-119
5858,0,0,10,0,-10
5859,0,0,29,0,-29
5860,0,0,40,0,-40
5861,0,0,28,0,-28
5862,1,0,9,0,-9
5863,1,0,37,0,-37
5864,1,0,29,0,-29
5865,1,1,1270,1304,34
5866,1,0,12,0,-12
5867,0,0,40,0,-40
5868,1,0,51,0,-51
5869,1,0,22,0,-22
5870,1,1,913,1248,335
5871,0,0,9,0,-9
5872,1,1,542,1252,710
5873,0,0,15,0,-15
5874,0,0,61,0,-61
5875,0,0,29,0,-29
5876,1,0,115,0,-115
5877,0,0,12,0,-12
5878,1,1,222,1302,1080
5879,1,1,540,1416,876
5880,0,0,19,0,-19
5881,0,0,82,0,-82
5882,0,0,42,0,-42
5883,1,0,93,0,-93
5884,0,0,118,0,-118
5885,0,0,0,0,0
5886,0,0,9,0,-9
5887,1,1,597,1340,743
5888,0,0,102,0,-102
5889,1,0,62,0,-62
5890,1,1,293,2268,1975
5891,1,1,2048,2251,203
5892,1,1,122,1325,1203
5893,0,0,92,0,-92
5894,1,1,143,1324,1181
5895,0,0,14,0,-14
5896,1,0,4,0,-4
5897,0,0,29,0,-29
5898,1,1,16,1298,1282
5899,0,0,84,0,-84
5900,0,0,41,0,-41
5901,1,1,93,1864,1771
5902,1,1,233,1306,1073
5903,0,0,26,0,-26
5904,0,0,86,0,-86
5905,1,0,53,0,-53
5906,0,0,107,0,-107
5907,0,0,27,0,-27
5908,1,1,254,1544,1290
5909,1,1,393,1375,982
5910,1,0,65,0,-65
5911,1,1,258,1545,1287
5912,1,0,9,0,-9
5913,1,0,38,0,-38
5914,1,0,48,0,-48
5915,0,0,48,0,-48
5916,1,1,346,1301,955
5917,0,0,90,0,-90
5918,1,1,258,2529,2271
5919,1,1,398,1245,847
5920,1,0,12,0,-12
5921,0,0,95,0,-95
5922,1,1,14,2483,2469
5923,1,0,105,0,-105
5924,0,0,21,0,-21
5925,0,0,29,0,-29
5926,1,0,127,0,-127
5927,0,0,39,0,-39
5928,1,1,289,1317,1028
5929,0,0,58,0,-58
5930,0,0,48,0,-48
5931,1,1,226,1599,1373
5932,0,0,336,0,-336
5933,0,0,11,0,-11
5934,0,0,77,0,-77
5935,1,1,598,5201,4603
5936,0,0,9,0,-9
5937,1,0,40,0,-40
5938,1,1,340,1288,948
5939,0,0,3,0,-3
5940,0,0,56,0,-56
5941,0,0,44,0,-44
5942,0,0,82,0,-82
5943,1,1,393,1777,1384
5944,1,1,1261,4566,3305
5945,0,0,38,0,-38
5946,1,1,288,1902,1614
5947,1,1,1567,3924,2357
5948,1,0,49,0,-49
5949,1,1,256,1571,1315
5950,0,0,60,0,-60
5951,1,0,9,0,-9
5952,1,1,33,1331,1298
5953,0,0,7,0,-7
5954,1,0,67,0,-67
5955,1,0,114,0,-114
5956,1,0,33,0,-33
5957,1,0,74,0,-74
5958,0,0,17,0,-17
5959,0,0,8,0,-8
5960,0,0,34,0,-34
5961,0,0,40,0,-40
5962,1,0,20,0,-20
5963,0,0,55,0,-55
5964,0,0,11,0,-11
5965,0,0,25,0,-25
5966,1,0,93,0,-93
5967,0,0,44,0,-44
5968,0,0,37,0,-37
5969,1,0,13,0,-13
5970,1,0,161,0,-161
5971,1,0,90,0,-90
5972,0,0,50,0,-50
5973,1,1,292,1751,1459
5974,1,0,62,0,-62
5975,0,0,103,0,-103
5976,0,0,43,0,-43
5977,0,0,52,0,-52
5978,1,0,47,0,-47
5979,0,0,35,0,-35
5980,1,0,25,0,-25
5981,1,0,49,0,-49
5982,1,1,221,1277,1056
5983,0,0,57,0,-57
5984,1,0,1,0,-1
5985,1,0,14,0,-14
5986,1,0,8,0,-8
5987,0,0,48,0,-48
5988,1,0,49,0,-49
5989,1,0,5,0,-5
5990,1,1,222,1262,1040
5991,0,0,0,0,0
5992,0,0,18,0,-18
5993,1,1,641,1305,664
5994,0,0,15,0,-15
5995,0,0,47,0,-47
5996,1,0,2,0,-2
5997,0,0,25,0,-25
5998,1,0,33,0,-33
5999,0,0,110,0,-110
6000,0,0,7,0,-7
6001,0,0,82,0,-82
6002,0,0,28,0,-28
6003,1,0,19,0,-19
6004,0,0,3,0,-3
6005,1,1,89,1395,1306
6006,0,0,12,0,-12
6007,0,0,40,0,-40
6008,1,0,87,0,-87
6009,1,0,21,0,-21
6010,1,1,494,1443,949
6011,0,0,25,0,-25
6012,0,0,25,0,-25
6013,1,0,80,0,-80
6014,1,0,4,0,-4
6015,0,0,24,0,-24
6016,1,0,38,0,-38
6017,0,0,26,0,-26
6018,1,1,239,1986,1747
6019,1,1,239,1371,1132
6020,1,1,437,2223,1786
6021,1,0,18,0,-18
6022,1,0,54,0,-54
6023,1,1,736,1829,1093
6024,1,1,343,1443,1100
6025,1,0,14,0,-14
6026,1,1,844,1401,557
6027,0,0,40,0,-40
6028,1,0,71,0,-71
6029,1,0,18,0,-18
6030,0,0,25,0,-25
6031,1,1,252,1468,1216
6032,1,0,9,0,-9
6033,1,0,2,0,-2
6034,0,0,6,0,-6
6035,1,0,48,0,-48
6036,1,1,245,1326,1081
6037,1,1,890,2050,1160
6038,0,0,22,0,-22
6039,0,0,38,0,-38
6040,0,0,28,0,-28
6041,0,0,14,0,-14
6042,1,0,48,0,-48
6043,1,0,46,0,-46
6044,1,0,8,0,-8
6045,1,1,152,1729,1577
6046,1,1,1272,1339,67
6047,1,0,103,0,-103
6048,0,0,8,0,-8
6049,1,0,43,0,-43
6050,1,0,26,0,-26
6051,0,0,47,0,-47
6052,1,0,28,0,-28
6053,0,0,44,0,-44
6054,0,0,112,0,-112
6055,1,0,105,0,-105
6056,0,0,2,0,-2
6057,1,0,55,0,-55
6058,0,0,110,0,-110
6059,0,0,2,0,-2
6060,1,1,642,1605,963
6061,1,0,152,0,-152
6062,1,0,14,0,-14
6063,1,0,61,0,-61
6064,1,0,8,0,-8
6065,1,1,18,1317,1299
6066,1,0,31,0,-31
6067,1,1,699,1374,675
6068,0,0,3,0,-3
6069,1,0,9,0,-9
6070,1,0,101,0,-101
6071,1,0,58,0,-58
6072,1,1,157,1285,1128
6073,1,1,399,1718,1319
6074,1,0,17,0,-17
6075,1,1,280,2971,2691
6076,1,1,786,1674,888
6077,0,0,93,0,-93
6078,0,0,17,0,-17
6079,1,1,305,3520,3215
6080,0,0,26,0,-26
6081,1,1,467,1411,944
6082,1,1,1453,1655,202
6083,0,0,39,0,-39
6084,1,0,114,0,-114
6085,0,0,42,0,-42
6086,0,0,31,0,-31
6087,1,0,56,0,-56
6088,0,0,16,0,-16
6089,1,0,48,0,-48
6090,1,1,200,1437,1237
6091,1,1,634,1518,884
6092,0,0,50,0,-50
6093,0,0,88,0,-88
6094,0,0,24,0,-24
6095,1,0,7,0,-7
6096,0,0,107,0,-107
6097,0,0,63,0,-63
6098,1,1,463,1367,904
6099,0,0,50,0,-50
6100,1,1,93,1434,1341
6101,0,0,66,0,-66
6102,1,0,62,0,-62
6103,0,0,6,0,-6
6104,1,0,29,0,-29
6105,0,0,75,0,-75
6106,1,1,344,1787,1443
6107,1,0,111,0,-111
6108,0,0,1,0,-1
6109,0,0,38,0,-38
6110,0,0,7,0,-7
6111,1,1,305,1323,1018
6112,1,1,41,1267,1226
6113,1,0,8,0,-8
6114,0,0,20,0,-20
6115,0,0,7,0,-7
6116,1,1,70,1492,1422
6117,1,0,50,0,-50
6118,0,0,9,0,-9
6119,1,1,38,1683,1645
6120,0,0,27,0,-27
6121,1,0,71,0,-71
6122,1,0,75,0,-75
6123,1,0,132,0,-132
6124,0,0,47,0,-47
6125,0,0,23,0,-23
6126,0,0,51,0,-51
6127,1,0,88,0,-88
6128,0,0,69,0,-69
6129,1,1,502,2705,2203
6130,1,0,13,0,-13
6131,0,0,18,0,-18
6132,1,1,187,1254,1067
6133,1,1,168,4564,4396
6134,1,1,411,2160,1749
6135,0,0,21,0,-21
6136,0,0,3,0,-3
6137,1,0,8,0,-8
6138,0,0,54,0,-54
6139,1,0,9,0,-9
6140,0,0,11,0,-11
6141,0,0,60,0,-60
6142,1,0,58,0,-58
6143,0,0,5,0,-5
6144,1,1,77,1903,1826
6145,0,0,64,0,-64
6146,1,0,24,0,-24
6147,0,0,40,0,-40
6148,1,0,37,0,-37
6149,1,0,103,0,-103
6150,0,0,241,0,-241
6151,1,0,76,0,-76
6152,0,0,27,0,-27
6153,1,1,831,1683,852
6154,0,0,0,0,0
6155,1,0,31,0,-31
6156,1,0,16,0,-16
6157,1,1,152,1244,1092
6158,1,0,43,0,-43
6159,0,0,8,0,-8
6160,1,1,926,1851,925
6161,1,1,194,1598,1404
6162,1,1,239,1336,1097
6163,0,0,1,0,-1
6164,0,0,76,0,-76
6165,0,0,79,0,-79
6166,1,1,807,1524,717
6167,0,0,23,0,-23
6168,1,1,51,2939,2888
6169,1,0,7,0,-7
6170,1,0,14,0,-14
6171,1,1,225,1476,1251
6172,0,0,3,0,-3
6173,1,0,21,0,-21
6174,0,0,31,0,-31
6175,1,1,262,1262,1000
6176,1,1,68,1548,1480
6177,1,1,386,1512,1126
6178,1,1,463,1462,999
6179,1,0,150,0,-150
6180,1,1,49,1350,1301
6181,1,1,329,2260,1931
6182,1,1,849,1363,514
6183,1,1,617,1461,844
6184,1,1,801,1737,936
6185,1,0,17,0,-17
6186,0,0,8,0,-8
6187,1,0,2,0,-2
6188,1,1,238,1833,1595
6189,1,1,59,1301,1242
6190,1,1,387,1263,876
6191,1,0,4,0,-4
6192,0,0,86,0,-86
6193,1,1,362,1830,1468
6194,1,1,221,1360,1139
6195,0,0,33,0,-33
6196,0,0,25,0,-25
6197,1,0,114,0,-114
6198,0,0,114,0,-114
6199,1,1,1393,1307,-86
6200,1,1,1192,2237,1045
6201,1,1,468,1281,813
6202,1,0,45,0,-45
6203,0,0,166,0,-166
6204,1,0,15,0,-15
6205,0,0,8,0,-8
6206,1,0,39,0,-39
6207,1,1,1265,1259,-6
6208,1,1,379,1238,859
6209,1,0,32,0,-32
6210,1,0,6,0,-6
6211,0,0,15,0,-15
6212,0,0,205,0,-205
6213,1,0,79,0,-79
6214,1,0,37,0,-37
6215,0,0,87,0,-87
6216,0,0,30,0,-30
6217,1,1,794,1562,768
6218,0,0,34,0,-34
6219,0,0,41,0,-41
6220,1,1,64,1931,1867
6221,0,0,49,0,-49
6222,0,0,73,0,-73
6223,0,0,35,0,-35
6224,0,0,35,0,-35
6225,1,1,325,1266,941
6226,1,1,1548,1309,-239
6227,1,1,171,1332,1161
6228,0,0,95,0,-95
6229,1,0,17,0,-17
6230,1,1,1148,1415,267
6231,0,0,21,0,-21
6232,0,0,95,0,-95
6233,1,0,5,0,-5
6234,0,0,146,0,-146
6235,1,0,158,0,-158
6236,0,0,24,0,-24
6237,0,0,103,0,-103
6238,1,0,227,0,-227
6239,0,0,0,0,0
6240,0,0,78,0,-78
6241,1,0,95,0,-95
6242,1,1,541,1533,992
6243,0,0,21,0,-21
6244,0,0,55,0,-55
6245,1,0,26,0,-26
6246,0,0,103,0,-103
6247,0,0,27,0,-27
6248,0,0,55,0,-55
6249,1,1,921,1331,410
6250,1,0,7,0,-7
6251,1,0,189,0,-189
6252,1,0,66,0,-66
6253,1,0,36,0,-36
6254,0,0,170,0,-170
6255,0,0,42,0,-42
6256,1,1,20,1771,1751
6257,1,1,322,1342,1020
6258,1,1,267,1314,1047
6259,0,0,101,0,-101
6260,0,0,12,0,-12
6261,1,0,44,0,-44
6262,1,0,38,0,-38
6263,1,0,113,0,-113
6264,1,1,27,1463,1436
6265,1,0,13,0,-13
6266,0,0,52,0,-52
6267,1,1,1892,2710,818
6268,0,0,74,0,-74
6269,1,1,95,1323,1228
6270,1,1,229,1256,1027
6271,1,0,14,0,-14
6272,1,0,27,0,-27
6273,1,0,1,0,-1
6274,1,1,58,1450,1392
6275,1,0,3,0,-3
6276,0,0,14,0,-14
6277,1,0,41,0,-41
6278,1,1,129,1494,1365
6279,0,0,116,0,-116
6280,0,0,21,0,-21
6281,0,0,118,0,-118
6282,1,0,38,0,-38
6283,1,1,272,1372,1100
6284,1,1,640,1491,851
6285,1,1,222,1430,1208
6286,1,0,12,0,-12
6287,1,0,17,0,-17
6288,0,0,75,0,-75
6289,0,0,123,0,-123
6290,0,0,6,0,-6
6291,0,0,88,0,-88
6292,1,1,294,1377,1083
6293,1,1,412,1311,899
6294,0,0,76,0,-76
6295,1,0,37,0,-37
6296,0,0,4,0,-4
6297,1,1,598,1357,759
6298,1,0,47,0,-47
6299,0,0,14,0,-14
6300,1,0,3,0,-3
6301,1,0,24,0,-24
6302,1,1,1182,1555,373
6303,0,0,42,0,-42
6304,1,1,132,1298,1166
6305,1,0,198,0,-198
6306,0,0,60,0,-60
6307,1,1,825,1421,596
6308,1,0,87,0,-87
6309,0,0,126,0,-126
6310,0,0,44,0,-44
6311,1,1,1587,1243,-344
6312,1,0,200,0,-200
6313,1,1,822,1347,525
6314,0,0,393,0,-393
6315,1,1,219,1609,1390
6316,0,0,122,0,-122
6317,0,0,2,0,-2
6318,1,1,207,1424,1217
6319,1,0,6,0,-6
6320,1,1,564,1323,759
6321,0,0,50,0,-50
6322,1,1,1229,1344,115
6323,1,1,476,1622,1146
6324,1,0,22,0,-22
6325,1,0,243,0,-243
6326,1,0,61,0,-61
6327,0,0,26,0,-26
6328,1,1,201,1444,1243
6329,1,0,4,0,-4
6330,1,0,46,0,-46
6331,1,0,12,0,-12
6332,0,0,14,0,-14
6333,1,1,393,2470,2077
6334,0,0,46,0,-46
6335,1,1,506,1329,823
6336,0,0,78,0,-78
6337,1,0,5,0,-5
6338,1,1,1069,1634,565
6339,1,1,68,2014,1946
6340,1,1,66,1365,1299
6341,0,0,68,0,-68
6342,1,0,13,0,-13
6343,0,0,11,0,-11
6344,0,0,117,0,-117
6345,0,0,59,0,-59
6346,1,1,143,1401,1258
6347,1,0,3,0,-3
6348,1,0,38,0,-38
6349,1,1,751,1265,514
6350,1,1,257,1396,1139
6351,0,0,92,0,-92
6352,1,1,422,1471,1049
6353,0,0,132,0,-132
6354,1,0,70,0,-70
6355,0,0,132,0,-132
6356,1,0,74,0,-74
6357,0,0,58,0,-58
6358,0,0,96,0,-96
6359,0,0,33,0,-33
6360,1,0,52,0,-52
6361,0,0,23,0,-23
6362,1,0,27,0,-27
6363,1,1,149,1308,1159
6364,1,1,316,1334,1018
6365,1,1,170,1303,1133
6366,1,1,237,1264,1027
6367,0,0,48,0,-48
6368,0,0,1,0,-1
6369,0,0,1,0,-1
6370,0,0,29,0,-29
6371,0,0,28,0,-28
6372,1,1,833,1482,649
6373,1,1,527,1436,909
6374,1,0,41,0,-41
6375,0,0,20,0,-20
6376,0,0,72,0,-72
6377,1,1,411,1709,1298
6378,0,0,112,0,-112
6379,0,0,55,0,-55
6380,1,1,407,1489,1082
6381,0,0,83,0,-83
6382,1,0,20,0,-20
6383,0,0,52,0,-52
6384,0,0,113,0,-113
6385,0,0,15,0,-15
6386,0,0,90,0,-90
6387,0,0,11,0,-11
6388,0,0,50,0,-50
6389,1,0,7,0,-7
6390,1,1,1576,1240,-336
6391,1,1,481,1241,760
6392,1,1,529,1428,899
6393,1,1,341,1640,1299
6394,1,0,4,0,-4
6395,0,0,11,0,-11
6396,1,0,42,0,-42
6397,0,0,4,0,-4
6398,1,1,270,1867,1597
6399,1,1,260,2323,2063
6400,1,1,1244,1358,114
6401,1,0,38,0,-38
6402,0,0,47,0,-47
6403,0,0,81,0,-81
6404,1,0,23,0,-23
6405,0,0,170,0,-170
6406,0,0,29,0,-29
6407,0,0,29,0,-29
6408,0,0,82,0,-82
6409,1,1,112,1458,1346
6410,1,0,5,0,-5
6411,1,0,162,0,-162
6412,1,0,45,0,-45
6413,0,0,16,0,-16
6414,0,0,39,0,-39
6415,1,0,6,0,-6
6416,1,0,3,0,-3
6417,0,0,95,0,-95
6418,1,1,537,1707,1170
6419,0,0,225,0,-225
6420,1,0,37,0,-37
6421,1,1,408,1305,897
6422,1,0,191,0,-191
6423,1,0,50,0,-50
6424,1,1,806,1279,473
6425,1,1,486,1606,1120
6426,0,0,8,0,-8
6427,0,0,57,0,-57
